state,county,name,totpop,totpopc,urb810,urb25,wm09,wm1015,wm1625,wm2644,wm45,wf09,wf1015,wf1625,wf2644,wf45,ofptot,stot,totpop2,wmtot,wftot,whtot,nwtot,region1,region2,fips,level,statefip
1,10,"FAIRFIELD",41050,40950,0,0,5979,3270,3629,3806,3211,5535,2955,3863,4083,3451,1185,83,41050,19895,19887,39782,1268,1,1,9001,1,9
1,30,"HARTFORD",44733,44733,3955,0,6423,3358,4408,4148,3410,6120,3173,4445,4567,3744,920,17,44733,21747,22049,43796,937,1,1,9003,1,9
1,50,"LITCHFIELD",41375,41375,0,0,6100,3487,3792,3742,3146,5955,3212,3899,4052,3202,784,4,41375,20267,20320,40587,788,1,1,9005,1,9
1,70,"MIDDLESEX",20723,20723,0,0,3070,1510,1889,1820,1653,2962,1493,2044,2075,1837,313,57,20723,9942,10411,20353,370,1,1,9007,1,9
1,90,"NEW HAVEN",37064,37064,5772,0,5391,2924,3409,3602,2815,5028,2698,3436,3763,3097,850,51,37064,18141,18022,36163,901,1,1,9009,1,9
1,110,"NEW LONDON",34707,34707,6214,0,4867,2625,3011,2839,2621,4656,2505,3271,3443,3213,1579,77,34707,15963,17088,33051,1656,1,1,9011,1,9
1,130,"TOLLAND",13779,13779,0,0,1991,1058,1210,1201,1221,1882,964,1353,1347,1332,220,0,13779,6681,6878,13559,220,1,1,9013,1,9
1,150,"WINDHAM",28611,28611,0,0,3991,2266,2532,2541,2407,3775,1931,2762,2963,2820,602,21,28611,13737,14251,27988,623,1,1,9015,1,9
1,0,"CONNECTICUT",262042,261942,15941,0,37812,20498,23880,23699,20484,35913,18931,25073,26293,22696,6453,310,262042,126373,128906,255279,6763,1,1,9000,2,9
2,50,"CUMBERLAND",42831,42831,7169,0,7156,3398,3906,4127,2545,7002,3282,4335,4194,2520,366,0,42831,21132,21333,42465,366,1,1,23005,1,23
2,90,"HANCOCK",30031,30031,0,0,5827,2447,2695,3055,1457,5563,2278,2532,2840,1246,91,0,30031,15481,14459,29940,91,1,1,23009,1,23
2,110,"KENNEBEC",32564,32564,0,0,6068,2672,2885,3128,1791,5727,2519,3032,3027,1541,174,0,32564,16544,15846,32390,174,1,1,23011,1,23
2,150,"LINCOLN",42992,42992,0,0,7860,3510,3900,4126,2571,7304,3391,3865,3912,2389,164,0,42992,21967,20861,42828,164,1,1,23015,1,23
2,170,"OXFORD",17630,17630,0,0,3374,1463,1541,1647,1003,3062,1487,1555,1631,854,13,0,17630,9028,8589,17617,13,1,1,23017,1,23
2,250,"SOMERSET",12910,12910,0,0,2521,1056,1030,1319,673,2465,926,1205,1150,565,0,0,12910,6599,6311,12910,0,1,1,23025,1,23
2,290,"WASHINGTON",7870,7870,0,0,1518,587,797,938,390,1377,594,660,669,304,36,0,7870,4230,3604,7834,36,1,1,23029,1,23
2,310,"YORK",41877,41877,0,0,6949,3330,3649,3739,2861,6631,3350,4106,4041,3096,125,0,41877,20528,21224,41752,125,1,1,23031,1,23
2,0,"MAINE",228705,228705,7169,0,41273,18463,20403,22079,13291,39131,17827,21290,21464,12515,969,0,228705,115509,112227,227736,969,1,1,23000,2,23
3,10,"BARNSTABLE",22211,22211,0,0,3629,1855,1881,2076,1465,3478,1621,1895,2291,1784,236,0,22211,10906,11069,21975,236,1,1,25001,1,25
3,30,"BERKSHIRE",35907,35907,0,0,5481,2973,3399,3154,2585,5502,2714,3684,3212,2550,653,0,35907,17592,17662,35254,653,1,1,25003,1,25
3,50,"BRISTOL",37168,37168,5651,0,5297,2775,3300,3278,2928,5056,2656,3684,3829,3441,924,0,37168,17578,18666,36244,924,1,1,25005,1,25
3,70,"DUKES",3290,3290,0,0,429,214,274,309,263,418,214,297,368,348,156,0,3290,1489,1645,3134,156,1,1,25007,1,25
3,90,"ESSEX",71888,71888,40785,0,10226,4990,7097,7347,4879,10026,4815,6912,8060,6676,860,0,71888,34539,36489,71028,860,1,1,25009,1,25
3,150,"HAMPSHIRE",76275,76275,0,0,11927,5932,7122,7014,5973,11443,5574,7334,7480,5870,606,0,76275,37968,37701,75669,606,1,1,25015,1,25
3,170,"MIDDLESEX",52789,52789,4959,0,7566,3876,5452,5304,4061,7386,3767,5113,5380,4510,374,0,52789,26259,26156,52415,374,1,1,25017,1,25
3,190,"NANTUCKET",6807,6807,6807,0,876,463,731,675,448,836,454,595,789,640,300,0,6807,3193,3314,6507,300,1,1,25019,1,25
3,210,"NORFOLK",31245,31245,0,0,4187,2306,3068,3110,2506,4158,2277,3160,3337,2880,256,0,31245,15177,15812,30989,256,1,1,25021,1,25
3,230,"PLYMOUTH",35169,35169,8628,0,4965,2662,2969,3168,3021,4843,2532,3285,3655,3649,420,0,35169,16785,17964,34749,420,1,1,25023,1,25
3,250,"SUFFOLK",34381,34381,33787,33787,4500,1924,3730,4482,1414,4472,2126,4061,4241,1947,1484,0,34381,16050,16847,32897,1484,1,1,25025,1,25
3,270,"WORCESTER",64910,64910,0,0,9847,4994,5995,5937,5433,9263,4441,6346,6587,5599,468,0,64910,32206,32236,64442,468,1,1,25027,1,25
3,0,"MASSACHUSETTS",472040,472040,100617,33787,68930,34964,45018,45854,34976,66881,33191,46366,49229,39894,6737,0,472040,229742,235561,465303,6737,1,1,25000,2,25
4,50,"CHESHIRE",40988,40988,0,0,6514,3454,3727,3629,3114,6122,3348,4152,3867,3000,61,0,40988,20438,20489,40927,61,1,1,33005,1,33
4,70,"COOS",3991,3991,0,0,729,341,336,394,266,669,324,359,370,183,20,0,3991,2066,1905,3971,20,1,1,33007,1,33
4,90,"GRAFTON",28462,28462,0,0,4992,2331,2551,2720,1699,4828,2164,2706,2778,1629,64,0,28462,14293,14105,28398,64,1,1,33009,1,33
4,110,"HILLSBOROUGH",49249,49249,0,0,7946,3917,4560,4575,3306,7538,3924,5028,4913,3313,229,0,49249,24304,24716,49020,229,1,1,33011,1,33
4,150,"ROCKINGHAM",50175,50175,6934,0,7466,3773,4254,4921,3786,6999,3502,4869,5537,4558,510,0,50175,24200,25465,49665,510,1,1,33015,1,33
4,170,"STRAFFORD",41595,41595,0,0,6637,4024,3437,4292,2291,6157,3997,3678,4475,2521,86,0,41595,20681,20828,41509,86,1,1,33017,1,33
4,0,"NEW HAMPSHIRE",214460,214460,6934,0,34284,17840,18865,20531,14462,32313,17259,20792,21940,15204,970,0,214460,105982,107508,213490,970,1,1,33000,2,33
5,10,"BRISTOL",5072,5072,0,0,706,374,511,462,318,665,323,466,590,399,221,37,5072,2371,2443,4814,258,1,1,44001,1,44
5,30,"KENT",9834,9834,0,0,1411,726,870,905,771,1354,677,902,1009,851,354,4,9834,4683,4793,9476,358,1,1,44003,1,44
5,50,"NEWPORT",16294,16294,7907,0,2238,1189,1482,1360,1108,2134,1184,1729,1585,1337,904,44,16294,7377,7969,15346,948,1,1,44005,1,44
5,70,"PROVIDENCE",30869,30769,10071,0,4188,2163,3184,2850,2196,4212,2139,3055,3109,2497,1263,13,30869,14581,15012,29593,1276,1,1,44007,1,44
5,90,"WASHINGTON",14962,14962,0,0,2192,1102,1203,1188,1146,2190,1066,1368,1342,1288,867,10,14962,6831,7254,14085,877,1,1,44009,1,44
5,0,"RHODE ISLAND",77031,76931,17978,0,10735,5554,7250,6765,5539,10555,5389,7520,7635,6372,3609,108,77031,35843,37471,73314,3717,1,1,44000,2,44
6,10,"ADDISON",19993,19993,0,0,3308,1611,2083,1968,1188,3252,1578,2049,1881,959,116,0,19993,10158,9719,19877,116,1,1,50001,1,50
6,30,"BENNINGTON",15893,15893,0,0,2762,1239,1370,1463,1033,2704,1229,1613,1501,934,45,0,15893,7867,7981,15848,45,1,1,50003,1,50
6,50,"CALEDONIA",18730,18730,0,0,3499,1466,1631,1983,893,3373,1381,1806,1858,811,29,0,18730,9472,9229,18701,29,1,1,50005,1,50
6,70,"CHITTENDEN",18120,18120,0,0,3226,1534,1694,1815,954,3139,1527,1610,1730,824,67,0,18120,9223,8830,18053,67,1,1,50007,1,50
6,90,"ESSEX",3087,3087,0,0,586,244,275,333,169,531,200,293,302,148,6,0,3087,1607,1474,3081,6,1,1,50009,1,50
6,110,"FRANKLIN",16427,16427,0,0,3071,1393,1490,1708,730,2964,1360,1501,1514,596,100,0,16427,8392,7935,16327,100,1,1,50011,1,50
6,130,"GRAND ISLE",3445,3445,0,0,653,332,294,328,191,610,285,282,297,159,14,0,3445,1798,1633,3431,14,1,1,50013,1,50
6,170,"ORANGE",25247,25247,0,0,4397,2290,2059,2421,1585,4283,2049,2370,2460,1282,51,0,25247,12752,12444,25196,51,1,1,50017,1,50
6,190,"ORLEANS",5830,5830,0,0,1199,426,544,685,234,1028,376,520,610,181,27,0,5830,3088,2715,5803,27,1,1,50019,1,50
6,210,"RUTLAND",29486,29486,0,0,5010,2530,2797,2681,1796,4898,2395,2931,2724,1625,99,0,29486,14814,14573,29387,99,1,1,50021,1,50
6,250,"WINDHAM",26760,26760,0,0,4560,2256,2324,2348,1925,4281,2141,2563,2514,1797,51,0,26760,13413,13296,26709,51,1,1,50025,1,50
6,270,"WINDSOR",34877,34877,0,0,5811,3026,3117,3058,2355,5558,2820,3445,3401,2141,145,0,34877,17367,17365,34732,145,1,1,50027,1,50
6,0,"VERMONT",217895,217895,0,0,38082,18347,19678,20791,13053,36621,17341,20983,20792,11457,750,0,217895,109951,107194,217145,750,1,1,50000,2,50
11,10,"KENT",20495,20495,0,0,2454,1186,1260,1534,669,2440,1137,1387,1498,586,5616,728,20495,7103,7048,14151,6344,5,3,10001,1,10
11,30,"NEW CASTLE",24429,24429,0,0,3243,1479,1903,2088,1232,2988,1467,1950,1936,1177,3919,1047,24429,9945,9518,19463,4966,5,3,10003,1,10
11,50,"SUSSEX",27750,27750,0,0,3935,1815,1987,2244,977,3613,1766,2204,2093,1113,3601,2402,27750,10958,10789,21747,6003,5,3,10005,1,10
11,0,"DELAWARE",72674,72674,0,0,9632,4480,5150,5866,2878,9041,4370,5541,5527,2876,13136,4177,72674,28006,27355,55361,17313,5,3,10000,2,10
12,30,"BERGEN",16603,16603,0,0,2122,1037,1180,1338,1202,2130,1040,1232,1276,1081,785,2180,16603,6879,6759,13638,2965,2,1,34003,1,34
12,50,"BURLINGTON",24972,24979,0,0,4108,1789,2060,2221,1716,3868,1853,2300,2428,1590,946,93,24972,11894,12039,23933,1039,2,1,34005,1,34
12,90,"CAPE MAY",3632,3632,0,0,617,285,318,384,199,563,234,332,317,191,111,81,3632,1803,1637,3440,192,2,1,34009,1,34
12,110,"CUMBERLAND",12670,12670,0,0,1911,1157,1183,1230,662,1811,1128,1244,1108,647,547,42,12670,6143,5938,12081,589,2,1,34011,1,34
12,130,"ESSEX",25984,25984,2977,0,3795,1867,2535,2375,1640,3519,1967,2448,2335,1616,758,1129,25984,12212,11885,24097,1887,2,1,34013,1,34
12,150,"GLOUCESTER",19744,19744,0,0,3249,1531,1821,1714,1290,3154,1411,1722,1738,1154,886,74,19744,9605,9179,18784,960,2,1,34015,1,34
12,190,"HUNTERDON",24556,24556,3000,0,3664,1827,2114,2074,1769,3572,1608,2240,2188,1694,687,1119,24556,11448,11302,22750,1806,2,1,34019,1,34
12,230,"MIDDLESEX",20381,20381,0,0,2878,1697,1675,1751,1402,2860,1642,1286,1778,1449,665,1298,20381,9403,9015,18418,1963,2,1,34023,1,34
12,250,"MONMOUTH",22150,22150,0,0,3356,1698,1655,1876,1557,3286,1452,1808,1851,1475,632,1504,22150,10142,9872,20014,2136,2,1,34025,1,34
12,270,"MORRIS",21828,21828,0,0,3625,1983,1813,1969,1315,3374,1750,1820,1882,1237,204,856,21828,10705,10063,20768,1060,2,1,34027,1,34
12,330,"SALEM",12761,12761,0,0,2014,1050,1141,1146,674,1865,835,1175,1114,681,1037,29,12761,6025,5670,11695,1066,2,1,34033,1,34
12,350,"SOMERSET",14725,14725,0,0,2003,1022,1226,1128,951,1762,1016,1228,1224,881,316,1968,14725,6330,6111,12441,2284,2,1,34035,1,34
12,370,"SUSSEX",25549,25549,0,0,4472,1971,2510,2188,1627,4301,1851,2349,2120,1413,269,478,25549,12768,12034,24802,747,2,1,34037,1,34
12,0,"NEW JERSEY",245555,245562,5977,0,37814,18914,21231,21394,16004,36065,17787,21184,21359,15109,7843,10851,245555,115357,111504,226861,18694,2,1,34000,2,34
13,10,"ALBANY",34661,34661,10762,0,5839,2560,3047,3432,2047,5588,2435,3121,3164,1790,866,772,34661,16925,16098,33023,1638,2,1,36001,1,36
13,30,"ALLEGANY",1942,1942,0,0,378,164,163,208,100,385,137,168,161,57,0,21,1942,1013,908,1921,21,2,1,36003,1,36
13,70,"BROOME",8130,8130,0,0,1448,689,759,831,483,1377,646,727,693,424,30,23,8130,4210,3867,8077,53,2,1,36007,1,36
13,110,"CAYUGA",29843,29843,0,0,5893,2403,2575,2861,1620,5575,2292,2537,2664,1262,86,75,29843,15352,14330,29682,161,2,1,36011,1,36
13,170,"CHENANGO",21704,21704,0,0,4254,1889,1895,2257,1113,3839,1536,1914,2018,900,76,13,21704,11408,10207,21615,89,2,1,36017,1,36
13,190,"CLINTON",8002,8002,0,0,1522,633,790,855,396,1411,594,748,662,330,32,29,8002,4196,3745,7941,61,2,1,36019,1,36
13,210,"COLUMBIA",32390,32390,4048,0,5091,2490,2835,3035,2087,4996,2222,3004,2891,2010,850,879,32390,15538,15123,30661,1729,2,1,36021,1,36
13,230,"CORTLAND",8869,8869,0,0,1816,785,676,999,385,1720,664,705,791,326,2,0,8869,4661,4206,8867,2,2,1,36023,1,36
13,250,"DELAWARE",20303,20303,0,0,3766,1604,1875,2026,1138,3761,1536,1705,1814,946,77,55,20303,10409,9762,20171,132,2,1,36025,1,36
13,270,"DUTCHESS",51363,51363,0,0,8419,4317,5074,4219,3132,7606,4218,4657,4340,2995,1124,1262,51363,25161,23816,48977,2386,2,1,36027,1,36
13,310,"ESSEX",9477,9477,0,0,1817,813,890,856,568,1773,729,808,841,379,3,0,9477,4944,4530,9474,3,2,1,36031,1,36
13,330,"FRANKLIN",2617,2617,0,0,472,170,441,355,113,457,71,241,224,70,0,3,2617,1551,1063,2614,3,2,1,36033,1,36
13,370,"GENESEE",12588,12588,0,0,2459,987,1355,1482,540,2273,806,1152,1123,386,14,11,12588,6823,5740,12563,25,2,1,36037,1,36
13,390,"GREENE",19536,19536,0,0,3494,1559,1729,1749,1016,3189,1546,1828,1768,920,371,367,19536,9547,9251,18798,738,2,1,36039,1,36
13,430,"HERKIMER",22046,22046,0,0,4258,1903,1789,2159,1249,3910,1770,1798,2055,1014,77,64,22046,11358,10547,21905,141,2,1,36043,1,36
13,450,"JEFFERSON",15140,15140,0,0,2960,1075,1829,1800,552,2835,951,1193,1472,433,40,0,15140,8216,6884,15100,40,2,1,36045,1,36
13,470,"KINGS",8303,8303,4402,0,946,465,665,855,475,906,401,684,640,413,735,1118,8303,3406,3044,6450,1853,2,1,36047,1,36
13,490,"LEWIS",6433,6433,0,0,1283,483,593,743,354,1161,424,501,607,255,25,4,6433,3456,2948,6404,29,2,1,36049,1,36
13,530,"MADISON",25144,25144,0,0,4840,1930,2094,2686,1246,4704,1772,2246,2346,1068,177,35,25144,12796,12136,24932,212,2,1,36053,1,36
13,570,"MONTGOMERY",41214,41214,0,0,7539,3410,3471,3611,2615,7159,3008,3583,3589,2152,365,712,41214,20646,19491,40137,1077,2,1,36057,1,36
13,610,"NEW YORK",96373,96373,96373,96373,13157,5395,8981,11833,4082,13074,6207,9950,9722,4149,8137,1686,96373,43448,43102,86550,9823,2,1,36061,1,36
13,630,"NIAGARA",8971,8971,0,0,1713,656,1132,1134,414,1504,552,825,755,247,31,8,8971,5049,3883,8932,39,2,1,36063,1,36
13,650,"ONEIDA",33792,33792,0,0,6306,2811,3038,3511,1755,6031,2521,2905,3207,1496,130,81,33792,17421,16160,33581,211,2,1,36065,1,36
13,670,"ONONDAGA",25987,25987,0,0,5022,2038,2477,2836,1280,4720,1891,2305,2282,972,114,50,25987,13653,12170,25823,164,2,1,36067,1,36
13,690,"ONTARIO",42032,42032,0,0,8239,3484,3617,4235,2263,7812,2964,3328,3756,1823,299,212,42032,21838,19683,41521,511,2,1,36069,1,36
13,710,"ORANGE",34347,34347,0,0,5543,2501,3397,3265,2028,5399,2495,3251,2899,1676,927,966,34347,16734,15720,32454,1893,2,1,36071,1,36
13,770,"OTSEGO",38802,38802,0,0,7282,3383,3220,3704,2129,7059,3010,3411,3564,1833,133,74,38802,19718,18877,38595,207,2,1,36077,1,36
13,810,"QUEENS",19336,19336,0,0,2413,1361,1411,1428,1583,2194,1263,1560,1505,1455,2354,809,19336,8196,7977,16173,3163,2,1,36081,1,36
13,830,"RENSSELAER",36309,36309,0,0,6248,2747,3285,3345,2240,6023,2613,3365,3227,2104,362,750,36309,17865,17332,35197,1112,2,1,36083,1,36
13,850,"RICHMOND",5347,5347,0,0,790,379,389,414,386,722,360,437,437,322,274,437,5347,2358,2278,4636,711,2,1,36085,1,36
13,870,"ROCKLAND",7758,7758,0,0,1169,516,685,714,570,1157,494,670,672,503,292,316,7758,3654,3496,7150,608,2,1,36087,1,36
13,890,"ST LAWRENCE",7885,7885,0,0,1422,491,1322,1078,289,1253,444,707,671,186,17,5,7885,4602,3261,7863,22,2,1,36089,1,36
13,910,"SARATOGA",33147,33147,0,0,5831,2717,2910,3212,2003,5392,2714,2925,2997,1774,565,107,33147,16673,15802,32475,672,2,1,36091,1,36
13,930,"SCHENECTADY",10201,10201,5903,0,1794,816,941,829,696,1528,798,897,823,573,188,318,10201,5076,4619,9695,506,2,1,36093,1,36
13,950,"SCHOHARIE",18945,18945,0,0,3534,1421,1593,1791,1112,3505,1309,1651,1619,859,235,316,18945,9451,8943,18394,551,2,1,36095,1,36
13,990,"SENECA",16609,16609,0,0,3438,1331,1332,1627,903,3231,1181,1350,1438,633,44,101,16609,8631,7833,16464,145,2,1,36099,1,36
13,1010,"STEUBEN",7246,7246,0,0,1450,579,605,757,364,1371,519,608,612,265,29,87,7246,3755,3375,7130,116,2,1,36101,1,36
13,1030,"SUFFOLK",21113,21113,0,0,3014,1621,1544,1880,1591,2983,1447,1710,2009,1528,1373,413,21113,9650,9677,19327,1786,2,1,36103,1,36
13,1050,"SULLIVAN",6108,6108,0,0,1189,487,583,617,352,1102,429,515,555,225,11,43,6108,3228,2826,6054,54,2,1,36105,1,36
13,1070,"TIOGA",7899,7899,0,0,1520,648,728,752,437,1424,598,673,687,332,39,61,7899,4085,3714,7799,100,2,1,36107,1,36
13,1110,"ULSTER",26576,26576,0,0,4138,1880,2302,2305,1818,3927,1770,2340,2146,1447,1066,1437,26576,12443,11630,24073,2503,2,1,36111,1,36
13,1150,"WASHINGTON",44289,44289,0,0,7739,3633,3104,3911,2382,7485,3308,3614,3846,2137,2815,315,44289,20769,20390,41159,3130,2,1,36115,1,36
13,1190,"WESTCHESTER",30272,30272,0,0,4488,2478,2638,2685,2079,4424,2166,2822,2513,2049,948,982,30272,14368,13974,28342,1930,2,1,36119,1,36
13,0,"NEW YORK",959049,959049,121488,96373,165933,73702,85779,94882,53985,157945,68811,85139,85805,46718,25333,15017,959049,474281,444418,918699,40350,2,1,36000,2,36
14,10,"ADAMS",15152,15152,0,0,2473,1199,1375,1349,1157,2356,1174,1454,1282,924,338,71,15152,7553,7190,14743,409,2,1,42001,1,42
14,30,"ALLEGHENY",25317,25317,4768,0,4547,1984,2423,2206,1761,4217,1974,2409,2077,1281,414,24,25317,12921,11958,24879,438,2,1,42003,1,42
14,50,"ARMSTRONG",6143,6143,0,0,1306,458,510,536,406,1158,477,536,499,253,4,0,6143,3216,2923,6139,4,2,1,42005,1,42
14,70,"BEAVER",12168,12168,0,0,2301,1002,1035,1067,787,2297,980,1030,1035,551,75,8,12168,6192,5893,12085,83,2,1,42007,1,42
14,90,"BEDFORD",15746,15746,0,0,2939,1269,1461,1334,1032,2745,1290,1485,1231,839,120,1,15746,8035,7590,15625,121,2,1,42009,1,42
14,110,"BERKS",43146,43146,3462,0,7904,3480,4046,3814,2649,7403,3406,4100,3387,2429,524,4,43146,21893,20725,42618,528,2,1,42011,1,42
14,170,"BUCKS",32371,32371,0,0,5345,2444,2742,3210,2300,4886,2225,2987,3061,2177,983,11,32371,16041,15336,31377,994,2,1,42017,1,42
14,190,"BUTLER",7346,7346,0,0,1428,540,593,633,608,1337,540,628,629,400,10,0,7346,3802,3534,7336,10,2,1,42019,1,42
14,210,"CAMBRIA",2117,2117,0,0,392,180,169,174,155,380,176,174,187,91,33,6,2117,1070,1008,2078,39,2,1,42021,1,42
14,270,"CENTRE",10681,10681,0,0,2049,874,971,991,636,1912,838,912,900,483,114,1,10681,5521,5045,10566,115,2,1,42027,1,42
14,290,"CHESTER",39596,39596,0,0,6136,3074,3425,3749,2759,5962,2992,3652,3531,2495,1814,7,39596,19143,18632,37775,1821,2,1,42029,1,42
14,330,"CLEARFIELD",875,875,0,0,169,50,84,75,59,151,66,80,68,38,35,0,875,437,403,840,35,2,1,42033,1,42
14,390,"CRAWFORD",6178,6178,0,0,1233,472,477,593,420,1192,460,483,537,289,20,2,6178,3195,2961,6156,22,2,1,42039,1,42
14,410,"CUMBERLAND",26757,26757,0,0,4656,2086,2517,2589,1634,4286,1977,2347,2524,1569,265,307,26757,13482,12703,26185,572,2,1,42041,1,42
14,430,"DAUPHIN",31883,31883,0,0,5531,2919,2871,2680,2010,5161,2771,2622,2921,2118,253,26,31883,16011,15593,31604,279,2,1,42043,1,42
14,450,"DELAWARE",14734,14734,0,0,2094,1343,1295,1358,994,1984,1332,1185,1399,928,822,0,14734,7084,6828,13912,822,2,1,42045,1,42
14,490,"ERIE",3758,3758,0,0,801,297,244,417,188,774,251,256,351,130,31,18,3758,1947,1762,3709,49,2,1,42049,1,42
14,510,"FAYETTE",24714,24714,0,0,4492,1875,2274,2054,1618,4399,1842,2289,1938,1285,590,58,24714,12313,11753,24066,648,2,1,42051,1,42
14,550,"FRANKLIN",23083,23083,0,0,3928,1752,2079,2175,1459,3607,1680,2169,2071,1152,924,87,23083,11393,10679,22072,1011,2,1,42055,1,42
14,590,"GREENE",12544,12544,0,0,2344,1062,1064,1015,797,2362,1008,1207,994,609,72,10,12544,6282,6180,12462,82,2,1,42059,1,42
14,610,"HUNTINGDON",14778,14778,0,0,2713,1209,1398,1185,1017,2564,1354,1359,1202,667,110,0,14778,7522,7146,14668,110,2,1,42061,1,42
14,630,"INDIANA",6214,6214,0,0,1195,520,556,507,421,1125,497,597,486,296,14,0,6214,3199,3001,6200,14,2,1,42063,1,42
14,650,"JEFFERSON",161,161,0,0,29,13,14,21,8,34,7,19,8,7,1,0,161,85,75,160,1,2,1,42065,1,42
14,710,"LANCASTER",53927,53927,5405,0,9010,4022,5093,5227,3347,8475,3949,5009,4977,3217,1557,44,53927,26699,25627,52326,1601,2,1,42071,1,42
14,790,"LUZERNE",18109,18109,0,0,3353,1503,1749,1643,1099,3235,1448,1600,1483,897,99,0,18109,9347,8663,18010,99,2,1,42079,1,42
14,810,"LYCOMING",11006,11006,0,0,1986,932,1109,962,751,1836,880,1061,882,541,64,2,11006,5740,5200,10940,66,2,1,42081,1,42
14,830,"MCKEAN",142,142,0,0,29,13,18,23,10,15,11,10,9,3,0,1,142,93,48,141,1,2,1,42083,1,42
14,850,"MERCER",8277,8277,0,0,1648,601,645,820,514,1671,532,679,744,376,44,3,8277,4228,4002,8230,47,2,1,42085,1,42
14,870,"MIFFLIN",12132,12132,0,0,2143,1003,1135,1068,802,2042,971,1137,1053,662,107,9,12132,6151,5865,12016,116,2,1,42087,1,42
14,910,"MONTGOMERY",29703,29703,0,0,4906,2341,2595,2711,2305,4595,2005,2790,2681,2100,671,3,29703,14858,14171,29029,674,2,1,42091,1,42
14,950,"NORTHAMPTON",38145,38145,0,0,6876,3544,3675,3150,2230,6468,3421,3440,2963,2189,189,0,38145,19475,18481,37956,189,2,1,42095,1,42
14,970,"NORTHUMBERLAND",36327,36327,0,0,6980,3022,3083,3314,2274,6433,2837,3270,3176,1741,194,3,36327,18673,17457,36130,197,2,1,42097,1,42
14,1010,"PHILADELPHIA",111210,111210,87303,53722,14575,6644,10798,11787,5828,14396,6987,11835,11396,6442,10514,8,111210,49632,51056,100688,10522,2,1,42101,1,42
14,1050,"POTTER",29,29,0,0,5,3,8,2,3,2,1,2,2,0,1,0,29,21,7,28,1,2,1,42105,1,42
14,1110,"SOMERSET",11284,11284,0,0,2233,873,992,961,733,2222,810,997,868,581,14,0,11284,5792,5478,11270,14,2,1,42111,1,42
14,1170,"TIOGA",1687,1687,0,0,343,116,167,176,100,309,137,140,135,64,0,0,1687,902,785,1687,0,2,1,42117,1,42
14,1210,"VENANGO",3060,3060,0,0,651,221,270,295,173,567,221,269,245,142,6,0,3060,1610,1444,3054,6,2,1,42121,1,42
14,1230,"WARREN",827,827,0,0,173,59,91,92,53,145,49,71,60,34,0,0,827,468,359,827,0,2,1,42123,1,42
14,1250,"WASHINGTON",36289,36289,0,0,6494,2723,3392,2777,2685,6341,2750,3587,2817,2117,570,36,36289,18071,17612,35683,606,2,1,42125,1,42
14,1270,"WAYNE",4125,4125,0,0,758,324,418,420,244,724,304,372,328,186,44,3,4125,2164,1914,4078,47,2,1,42127,1,42
14,1290,"WESTMORELAND",26392,26392,0,0,4895,2110,2331,2063,1887,4706,2106,2544,2006,1479,245,20,26392,13286,12841,26127,265,2,1,42129,1,42
14,1330,"YORK",31958,31958,2847,0,5401,2350,3011,2970,2187,5295,2207,3167,2683,2058,607,22,31958,15919,15410,31329,629,2,1,42133,1,42
14,0,"PENNSYLVANIA",810091,810091,103785,53722,138464,62506,74203,74193,52100,131769,60943,75960,70826,45840,22492,795,810091,401466,385338,786804,23287,2,1,42000,2,42
21,1570,"RANDOLPH",7275,7275,0,0,1310,535,771,766,286,1159,446,647,516,211,500,128,7275,3668,2979,6647,628,3,2,17157,1,17
21,1630,"ST CLAIR",5007,5007,0,0,956,410,503,573,270,860,345,406,378,153,113,40,5007,2712,2142,4854,153,3,2,17163,1,17
21,0,"ILLINOIS",12282,12282,0,0,2266,945,1274,1339,556,2019,791,1053,894,364,613,168,12282,6380,5121,11501,781,3,2,17000,2,17
22,190,"CLARK",5670,5670,0,0,1186,433,516,560,248,1073,415,478,466,174,40,81,5670,2943,2606,5549,121,3,2,18019,1,18
22,290,"DEARBORN",7310,7310,0,0,1481,533,711,679,346,1419,551,677,565,256,92,0,7310,3750,3468,7218,92,3,2,18029,1,18
22,610,"HARRISON",3595,3595,0,0,788,309,330,295,144,689,284,387,234,102,12,21,3595,1866,1696,3562,33,3,2,18061,1,18
22,830,"KNOX",7945,7945,0,0,1468,647,727,782,387,1374,613,686,615,262,249,135,7945,4011,3550,7561,384,3,2,18083,1,18
22,0,"INDIANA",24520,24520,0,0,4923,1922,2284,2316,1125,4555,1863,2228,1880,794,393,237,24520,12570,11320,23890,630,3,2,18000,2,18
23,8010,"DETROIT",2227,2227,0,0,393,168,231,291,171,252,179,190,160,79,96,17,2227,1254,860,2114,113,3,2,,1,26
23,8030,"ERIE",1340,1340,0,0,251,106,108,197,88,243,98,105,97,34,9,4,1340,750,577,1327,13,3,2,,1,26
23,8050,"HURON",580,580,0,0,97,56,62,68,37,114,36,55,42,11,0,2,580,320,258,578,2,3,2,,1,26
23,8070,"MICHILIMACKINAC",615,615,0,0,59,21,182,207,44,31,19,18,12,6,15,1,615,513,86,599,16,3,2,,1,26
23,0,"MICHIGAN",4762,4762,0,0,800,351,583,763,340,640,332,368,311,130,120,24,4762,2837,1781,4618,144,3,2,26000,2,26
24,10,"ADAMS",9434,9434,0,0,2008,784,699,804,530,1890,723,806,794,375,21,0,9434,4825,4588,9413,21,3,2,39001,1,39
24,90,"ATHENS",2791,2791,0,0,561,234,241,283,144,517,210,260,235,102,4,0,2791,1463,1324,2787,4,3,2,39009,1,39
24,130,"BELMONT",11097,11097,0,0,2352,858,890,980,641,2103,802,960,923,500,88,0,11097,5721,5288,11009,88,3,2,39013,1,39
24,170,"BUTLER",11150,11150,0,0,2217,869,987,1088,584,2099,865,1002,943,417,79,0,11150,5745,5326,11071,79,3,2,39017,1,39
24,210,"CHAMPAIGN",6303,6303,0,0,1311,437,614,630,310,1226,443,555,487,225,65,0,6303,3302,2936,6238,65,3,2,39021,1,39
24,250,"CLERMONT",9965,9965,0,0,1951,792,865,854,519,2122,817,855,768,385,37,0,9965,4981,4947,9928,37,3,2,39025,1,39
24,270,"CLINTON",2674,2674,0,0,523,185,198,296,114,591,194,225,241,98,9,0,2674,1316,1349,2665,9,3,2,39027,1,39
24,290,"COLUMBIANA",10878,10878,0,0,2168,886,848,1013,614,2156,776,953,917,448,99,0,10878,5529,5250,10779,99,3,2,39029,1,39
24,350,"CUYAHOGA",1459,1459,0,0,235,111,184,189,79,264,107,116,123,37,14,0,1459,798,647,1445,14,3,2,39035,1,39
24,410,"DELAWARE",2000,2000,0,0,386,130,205,207,105,365,130,191,164,73,44,0,2000,1033,923,1956,44,3,2,39041,1,39
24,450,"FAIRFIELD",11361,11361,0,0,2377,895,881,1175,600,2272,799,956,962,409,35,0,11361,5928,5398,11326,35,3,2,39045,1,39
24,470,"FAYETTE",1854,1854,0,0,388,144,184,177,81,370,127,178,146,55,4,0,1854,974,876,1850,4,3,2,39047,1,39
24,490,"FRANKLIN",3486,3486,0,0,636,271,335,400,154,628,273,350,279,117,43,0,3486,1796,1647,3443,43,3,2,39049,1,39
24,530,"GALLIA",4181,4181,0,0,865,314,374,398,224,808,345,374,329,135,15,0,4181,2175,1991,4166,15,3,2,39053,1,39
24,550,"GEAUGA",2917,2917,0,0,555,226,307,335,141,553,184,279,236,98,3,0,2917,1564,1350,2914,3,3,2,39055,1,39
24,570,"GREENE",5870,5870,0,0,1151,478,528,572,310,1149,421,517,485,223,36,0,5870,3039,2795,5834,36,3,2,39057,1,39
24,590,"GUERNSEY",3051,3051,0,0,641,244,272,305,154,586,215,270,263,94,7,0,3051,1616,1428,3044,7,3,2,39059,1,39
24,610,"HAMILTON",15258,15258,2540,0,2953,1237,1450,1443,803,2727,1151,1404,1351,581,158,0,15258,7886,7214,15100,158,3,2,39061,1,39
24,710,"HIGHLAND",5766,5766,0,0,1266,414,513,569,282,1038,417,456,466,219,126,0,5766,3044,2596,5640,126,3,2,39071,1,39
24,810,"JEFFERSON",17260,17260,0,0,3622,1322,1289,1547,998,3407,1289,1438,1484,740,124,0,17260,8778,8358,17136,124,3,2,39081,1,39
24,830,"KNOX",2149,2149,0,0,456,156,165,275,93,425,144,111,244,68,12,0,2149,1145,992,2137,12,3,2,39083,1,39
24,890,"LICKING",3852,3852,0,0,803,274,373,413,185,742,289,299,330,136,8,0,3852,2048,1796,3844,8,3,2,39089,1,39
24,970,"MADISON",1603,1603,0,0,323,122,182,166,83,282,94,164,120,54,13,0,1603,876,714,1590,13,3,2,39097,1,39
24,1090,"MIAMI",3941,3941,0,0,811,295,344,429,168,778,254,380,323,138,21,0,3941,2047,1873,3920,21,3,2,39109,1,39
24,1130,"MONTGOMERY",7722,7722,0,0,1541,617,693,790,390,1441,568,662,644,322,54,0,7722,4031,3637,7668,54,3,2,39113,1,39
24,1190,"MUSKINGUM",10036,10036,0,0,1909,947,950,1038,461,1841,845,829,772,369,75,0,10036,5305,4656,9961,75,3,2,39119,1,39
24,1290,"PICKAWAY",7124,7124,0,0,1425,527,698,742,334,1344,509,650,594,232,69,0,7124,3726,3329,7055,69,3,2,39129,1,39
24,1330,"PORTAGE",2995,2995,0,0,607,213,294,341,157,558,212,239,264,103,7,0,2995,1612,1376,2988,7,3,2,39133,1,39
24,1350,"PREBLE",3304,3304,0,0,731,259,248,332,144,679,224,269,288,105,25,0,3304,1714,1565,3279,25,3,2,39135,1,39
24,1410,"ROSS",15514,15514,0,0,3042,1155,1453,1541,759,2873,1073,1366,1342,540,370,0,15514,7950,7194,15144,370,3,2,39141,1,39
24,1450,"SCIOTO",3399,3399,0,0,703,272,307,342,168,635,248,287,287,121,29,0,3399,1792,1578,3370,29,3,2,39145,1,39
24,1510,"STARK",2734,2734,0,0,584,184,266,301,127,558,187,229,212,79,7,0,2734,1462,1265,2727,7,3,2,39151,1,39
24,1550,"TRUMBULL",8671,8671,0,0,1709,686,773,934,488,1560,558,728,794,386,55,0,8671,4590,4026,8616,55,3,2,39155,1,39
24,1570,"TUSCARAWAS",3045,3045,0,0,615,238,253,316,160,647,181,263,258,108,6,0,3045,1582,1457,3039,6,3,2,39157,1,39
24,1650,"WARREN",9925,9925,0,0,2024,837,831,950,510,1857,728,865,861,373,89,0,9925,5152,4684,9836,89,3,2,39165,1,39
24,1670,"WASHINGTON",5991,5991,0,0,1174,506,495,586,351,1101,467,504,507,252,48,0,5991,3112,2831,5943,48,3,2,39167,1,39
24,0,"OHIO",230760,230760,2540,0,46623,18119,20189,22761,11965,44192,16869,19990,19436,8717,1899,0,230760,119657,109204,228861,1899,3,2,39000,2,39
34,310,"CAPE GIRARDEAU",3888,3888,0,0,693,258,273,380,146,625,275,275,261,105,8,589,3888,1750,1541,3291,597,4,2,29031,1,29
34,1430,"NEW MADRID",2103,2103,0,0,310,150,173,193,111,338,165,164,141,66,5,287,2103,937,874,1811,292,4,2,29143,1,29
34,1830,"ST CHARLES",3505,3505,0,0,660,224,305,347,183,657,231,256,257,101,13,271,3505,1719,1502,3221,284,4,2,29183,1,29
34,1890,"ST LOUIS",5667,5667,0,0,942,360,513,590,283,866,330,432,326,165,120,740,5667,2688,2119,4807,860,4,2,29189,1,29
34,1930,"ST GENEVIEVE",4620,4620,0,0,672,269,214,411,174,578,205,232,306,112,459,988,4620,1740,1433,3173,1447,4,2,29186,1,29
34,8810,"ARKANSAS",874,874,0,0,132,70,73,127,61,123,47,56,63,13,2,107,874,463,302,765,109,4,2,,1,29
34,8830,"HOPEFIELD/ST FRANCIS",188,188,0,0,29,14,17,21,9,26,12,16,15,0,0,29,188,90,69,159,29,4,2,,1,29
34,0,"MISSOURI",20845,20845,0,0,3438,1345,1568,2069,967,3213,1265,1431,1369,562,607,3011,20845,9387,7840,17227,3618,4,2,29000,2,29
40,10,"ACCOMACK",15743,15743,0,0,1562,694,827,904,471,1531,688,1037,1110,517,1860,4542,15743,4458,4883,9341,6402,5,3,51001,1,51
40,30,"ALBEMARLE",18268,18268,0,0,1469,680,805,842,589,1394,656,888,759,560,400,9226,18268,4385,4257,8642,9626,5,3,51003,1,51
40,70,"AMELIA",10594,10594,0,0,557,241,304,358,204,496,224,347,306,216,155,7186,10594,1664,1589,3253,7341,5,3,51007,1,51
40,90,"AMHERST",10548,10548,0,0,917,376,448,513,340,962,331,470,461,325,198,5207,10548,2594,2549,5143,5405,5,3,51009,1,51
40,150,"AUGUSTA",14308,14308,0,0,1961,821,1168,1026,841,1889,721,1187,917,701,196,2880,14308,5817,5415,11232,3076,5,3,51015,1,51
40,170,"BATH",4837,4837,0,0,716,300,371,349,270,717,287,352,327,217,49,882,4837,2006,1900,3906,931,5,3,51017,1,51
40,190,"BEDFORD",16148,16148,0,0,1810,733,887,1004,599,1687,749,904,864,552,212,6147,16148,5033,4756,9789,6359,5,3,51019,1,51
40,195,"BERKELEY",11479,11479,0,0,1673,823,908,868,694,1614,734,1086,827,533,190,1529,11479,4966,4794,9760,1719,5,3,54003,1,51
40,230,"BOTETOURT",13301,13301,0,0,1917,788,1030,677,1893,739,973,573,1034,1102,300,2275,13301,6305,4421,10726,2575,5,3,51023,1,51
40,245,"BROOKE",5843,5843,0,0,1093,427,505,417,377,973,412,574,416,278,39,332,5843,2819,2653,5472,371,5,3,54009,1,51
40,250,"BRUNSWICK",15411,15411,0,0,1036,358,454,514,352,977,388,621,561,404,378,9368,15411,2714,2951,5665,9746,5,3,51025,1,51
40,290,"BUCKINGHAM",20059,20059,0,0,1602,647,698,745,419,1317,582,711,606,453,604,11675,20059,4111,3669,7780,12279,5,3,51029,1,51
40,295,"CABELL",2717,2717,0,0,576,184,209,244,132,423,201,211,196,95,25,221,2717,1345,1126,2471,246,5,3,54011,1,51
40,310,"CAMPBELL",11001,11001,0,0,954,410,539,581,361,866,388,492,464,315,263,5368,11001,2845,2525,5370,5631,5,3,51031,1,51
40,330,"CAROLINE",17544,17544,0,0,1061,506,612,574,406,993,503,699,623,475,328,10764,17544,3159,3293,6452,11092,5,3,51033,1,51
40,360,"CHARLES CITY",5186,5186,0,0,261,134,165,194,92,296,159,191,173,111,387,3023,5186,846,930,1776,3410,5,3,51036,1,51
40,370,"CHARLOTTE",13161,13161,0,0,963,401,490,495,342,898,390,567,490,318,210,7597,13161,2691,2663,5354,7807,5,3,51037,1,51
40,410,"CHESTERFIELD",9979,9979,0,0,608,314,379,341,221,624,332,352,296,225,272,6015,9979,1863,1829,3692,6287,5,3,51041,1,51
40,470,"CULPEPER",18967,18967,0,0,1800,807,986,1007,692,1630,781,1034,996,658,264,8312,18967,5292,5099,10391,8576,5,3,51047,1,51
40,490,"CUMBERLAND",9992,9992,0,0,616,295,368,428,213,590,266,383,353,203,175,6102,9992,1920,1795,3715,6277,5,3,51049,1,51
40,530,"DINWIDDIE",12524,12522,0,0,723,338,455,475,317,717,310,455,475,341,476,7442,12524,2308,2298,4606,7918,5,3,51053,1,51
40,550,"ELIZABETH CITY",3608,3608,0,0,287,122,182,204,95,291,115,177,215,111,75,1734,3608,890,909,1799,1809,5,3,51055,1,51
40,570,"ESSEX",9376,9376,0,0,541,276,310,345,196,476,228,389,377,273,306,5659,9376,1668,1743,3411,5965,5,3,51057,1,51
40,590,"FAIRFAX",13111,13111,0,0,1070,518,600,579,502,1017,541,685,650,464,543,5942,13111,3269,3357,6626,6485,5,3,51059,1,51
40,610,"FAUQUIER",22689,22689,0,0,2123,885,1031,1170,790,2006,853,1157,1190,779,344,10361,22689,5999,5985,11984,10705,5,3,51061,1,51
40,650,"FLUVANNA",4775,4775,0,0,408,176,243,259,171,418,196,296,234,175,57,2142,4775,1257,1319,2576,2199,5,3,51065,1,51
40,670,"FRANKLIN",10724,10724,0,0,1454,640,799,666,479,1433,597,820,645,433,86,2672,10724,4038,3928,7966,2758,5,3,51067,1,51
40,690,"FREDERICK",22574,22574,0,0,2643,1298,1490,1407,1030,2483,1271,1604,1429,892,610,6417,22574,7868,7679,15547,7027,5,3,51069,1,51
40,710,"GILES",3745,3745,0,0,647,274,343,263,212,630,250,332,254,273,25,242,3745,1739,1739,3478,267,5,3,51071,1,51
40,730,"GLOUCESTER",10427,10427,0,0,764,310,349,416,220,717,356,416,418,217,446,5798,10427,2059,2124,4183,6244,5,3,51073,1,51
40,750,"GOOCHLAND",10203,10203,0,0,683,349,352,379,297,644,331,481,414,300,509,5464,10203,2060,2170,4230,5973,5,3,51075,1,51
40,770,"GRAYSON",4941,4941,0,0,927,366,366,424,255,939,348,375,397,244,30,270,4941,2338,2303,4641,300,5,3,51077,1,51
40,775,"GREENBRIER",5914,5914,0,0,1056,429,490,483,356,949,375,527,459,266,30,494,5914,2814,2576,5390,524,5,3,54025,1,51
40,810,"GREENSVILLE",6853,6853,0,0,390,155,237,241,112,365,167,215,263,109,0,4599,6853,1135,1119,2254,4599,5,3,51081,1,51
40,830,"HALIFAX",22133,22133,0,0,2290,909,1101,1060,753,2125,826,1282,1113,658,353,9663,22133,6113,6004,12117,10016,5,3,51083,1,51
40,835,"HAMPSHIRE",9784,9784,0,0,1599,758,785,724,612,1506,696,855,685,511,124,929,9784,4478,4253,8731,1053,5,3,54027,1,51
40,850,"HANOVER",15082,15082,0,0,936,499,525,607,435,941,470,681,662,463,409,8454,15082,3002,3217,6219,8863,5,3,51085,1,51
40,855,"HARDY",5525,5525,0,0,781,394,461,354,343,785,339,442,384,296,197,749,5525,2333,2246,4579,946,5,3,54031,1,51
40,865,"HARRISON",9958,9958,0,0,1962,797,820,779,581,1775,713,816,759,446,51,459,9958,4939,4509,9448,510,5,3,54033,1,51
40,870,"HENRICO",9945,9945,0,0,742,284,349,463,273,708,291,464,514,296,715,4846,9945,2111,2273,4384,5561,5,3,51087,1,51
40,890,"HENRY",5611,5611,0,0,630,288,355,321,229,629,291,374,310,214,215,1755,5611,1823,1818,3641,1970,5,3,51089,1,51
40,930,"ISLE OF WIGHT",9186,9186,0,0,716,321,441,444,239,631,319,584,483,269,698,4041,9186,2161,2286,4447,4739,5,3,51093,1,51
40,950,"JAMES CITY",4094,4094,0,0,240,119,104,142,81,211,85,140,169,63,420,2320,4094,686,668,1354,2740,5,3,51095,1,51
40,955,"JEFFERSON",11851,11851,0,0,1482,617,765,811,521,1269,575,791,734,402,352,3532,11851,4196,3771,7967,3884,5,3,54037,1,51
40,965,"KANAWHA",3866,3866,0,0,677,269,336,383,180,678,234,295,282,134,46,352,3866,1845,1623,3468,398,5,3,54039,1,51
40,970,"KING AND QUEEN",10988,10988,0,0,763,327,457,453,267,747,307,563,510,324,267,6003,10988,2267,2451,4718,6270,5,3,51097,1,51
40,990,"KING GEORGE",6454,6454,0,0,356,191,227,254,162,334,149,264,284,160,197,3876,6454,1190,1191,2381,4073,5,3,51099,1,51
40,1010,"KING WILLIAM",9285,9285,0,0,545,228,307,340,192,477,256,389,346,214,203,5788,9285,1612,1682,3294,5991,5,3,51101,1,51
40,1030,"LANCASTER",5592,5592,0,0,384,153,188,261,118,344,168,241,278,141,204,3112,5592,1104,1172,2276,3316,5,3,51103,1,51
40,1050,"LEE",4694,4694,0,0,926,365,400,371,186,844,342,393,367,143,21,336,4694,2248,2089,4337,357,5,3,51105,1,51
40,1070,"LOUDOUN",21338,21338,0,0,2678,1165,1475,1574,926,2682,1085,1645,1421,926,604,5157,21338,7818,7759,15577,5761,5,3,51107,1,51
40,1090,"LOUISA",11900,11900,0,0,924,436,416,506,414,829,359,522,517,330,157,6490,11900,2696,2557,5253,6647,5,3,51109,1,51
40,1110,"LUNENBURG",12265,12265,0,0,924,353,431,497,283,817,320,491,498,319,177,7155,12265,2488,2445,4933,7332,5,3,51111,1,51
40,1130,"MADISON",8381,8381,0,0,752,335,330,380,409,357,613,464,391,292,88,3970,8381,2206,2117,4323,4058,5,3,51113,1,51
40,1148,"MASON",1991,1991,0,0,352,136,168,163,96,340,127,131,154,75,0,249,1991,915,827,1742,249,5,3,54053,1,51
40,1150,"MATHEWS",4227,4227,0,0,422,164,157,233,103,342,173,226,195,103,41,2068,4227,1079,1039,2118,2109,5,3,51115,1,51
40,1170,"MECKLENBURG",18453,18453,0,0,1386,608,672,701,455,1387,541,724,745,477,493,10264,18453,3822,3874,7696,10757,5,3,51117,1,51
40,1190,"MIDDLESEX",4414,4414,0,0,294,141,151,182,87,301,162,182,220,91,127,2476,4414,855,956,1811,2603,5,3,51119,1,51
40,1195,"MONONGALIA",12793,12793,0,0,2580,1186,960,941,553,2574,1332,908,934,437,37,351,12793,6220,6185,12405,388,5,3,54061,1,51
40,1205,"MONROE",5444,5444,0,0,981,375,467,443,317,889,382,525,382,237,70,376,5444,2583,2415,4998,446,5,3,54063,1,51
40,1210,"MONTGOMERY",8409,8409,0,0,1348,587,680,612,432,1359,561,691,596,387,57,1099,8409,3659,3594,7253,1156,5,3,51121,1,51
40,1230,"NANSEMOND",10324,10324,0,0,746,341,387,571,288,705,389,416,472,278,1269,4462,10324,2333,2260,4593,5731,5,3,51123,1,51
40,1250,"NELSON",9684,9684,0,0,862,368,411,481,331,843,366,480,406,349,108,4679,9684,2453,2444,4897,4787,5,3,51125,1,51
40,1270,"NEW KENT",6478,6478,0,0,372,222,228,265,138,354,186,264,269,147,308,3725,6478,1225,1220,2445,4033,5,3,51127,1,51
40,1290,"NORFOLK",13679,13679,0,0,1160,676,653,815,376,1123,656,773,748,465,587,5647,13679,3680,3765,7445,6234,5,3,51129,1,51
40,1310,"NORTHAMPTON",7474,7474,0,0,512,255,314,350,184,534,206,363,354,144,908,3350,7474,1615,1601,3216,4258,5,3,51131,1,51
40,1330,"NORTHUMBERLAND",8308,8308,0,0,741,291,345,415,213,665,295,498,469,230,299,3847,8308,2005,2157,4162,4146,5,3,51133,1,51
40,1350,"NOTTOWAY",9278,9278,0,0,449,198,288,295,150,455,193,288,271,143,180,6368,9278,1380,1350,2730,6548,5,3,51135,1,51
40,1355,"OHIO",8175,8175,0,0,1497,624,685,644,507,1475,621,661,622,345,54,440,8175,3957,3724,7681,494,5,3,54069,1,51
40,1370,"ORANGE",12323,12323,0,0,1011,405,433,665,355,1010,456,540,494,342,96,6516,12323,2869,2842,5711,6612,5,3,51137,1,51
40,1410,"PATRICK",4695,4695,0,0,934,113,198,320,301,289,723,188,324,306,275,724,4695,1866,1830,3696,999,5,3,51141,1,51
40,1415,"PENDLETON",4239,4239,0,0,735,288,410,350,234,694,305,404,310,222,25,262,4239,2017,1935,3952,287,5,3,54071,1,51
40,1430,"PITTSYLVANIA",17172,17172,0,0,2003,792,1032,1007,664,1885,789,1007,918,613,150,6312,17172,5498,5212,10710,6462,5,3,51143,1,51
40,1450,"POWHATAN",8073,8073,0,0,390,199,238,264,141,384,207,261,245,155,498,5091,8073,1232,1252,2484,5589,5,3,51145,1,51
40,1470,"PRINCE EDWARD",12409,12409,0,0,916,410,565,477,310,868,386,484,517,331,149,6996,12409,2678,2586,5264,7145,5,3,51147,1,51
40,1490,"PRINCE GEORGE",8050,8050,0,0,487,224,297,361,191,489,186,323,309,234,463,4486,8050,1560,1541,3101,4949,5,3,51149,1,51
40,1510,"PRINCESS ANNE",9498,9498,0,0,920,424,523,587,227,845,388,562,573,256,267,3926,9498,2681,2624,5305,4193,5,3,51151,1,51
40,1530,"PRINCE WILLIAM",11311,11311,0,0,935,443,515,513,381,908,447,646,581,364,358,5220,11311,2787,2946,5733,5578,5,3,51153,1,51
40,1567,"RANDOLPH",2854,2854,0,0,593,266,286,161,174,495,242,249,134,106,37,111,2854,1480,1226,2706,148,5,3,54083,1,51
40,1590,"RICHMOND",6214,6214,0,0,436,207,240,278,158,455,198,327,293,183,261,3178,6214,1319,1456,2775,3439,5,3,51159,1,51
40,1630,"ROCKBRIDGE",10318,10318,0,0,1442,672,866,791,579,1362,632,800,778,523,149,1724,10318,4350,4095,8445,1873,5,3,51163,1,51
40,1650,"ROCKINGHAM",12753,12753,0,0,1957,857,1077,973,752,1863,830,1109,978,653,213,1491,12753,5616,5433,11049,1704,5,3,51165,1,51
40,1670,"RUSSELL",6319,6319,0,0,1205,502,545,451,327,1149,422,551,495,250,36,386,6319,3030,2867,5897,422,5,3,51167,1,51
40,1710,"SHENANDOAH",13646,13646,0,0,2166,1042,1331,1088,763,2099,916,1368,1013,675,147,1038,13646,6390,6071,12461,1185,5,3,51171,1,51
40,1750,"SOUTHAMPTON",13497,13497,0,0,1002,447,541,621,323,843,471,652,633,449,1109,6406,13497,2934,3048,5982,7515,5,3,51175,1,51
40,1770,"SPOTSYLVANIA",13296,13296,0,0,845,451,516,589,383,842,406,562,568,434,565,7135,13296,2784,2812,5596,7700,5,3,51177,1,51
40,1790,"STAFFORD",9830,9830,0,0,860,392,508,493,337,767,435,601,535,391,316,4195,9830,2590,2729,5319,4511,5,3,51179,1,51
40,1810,"SURRY",6855,6855,0,0,445,197,274,284,155,409,209,281,307,190,664,3440,6855,1355,1396,2751,4104,5,3,51181,1,51
40,1830,"SUSSEX",11362,11362,0,0,728,328,457,455,253,676,302,494,452,291,582,6344,11362,2221,2215,4436,6926,5,3,51183,1,51
40,1850,"TAZEWELL",3007,3007,0,0,565,221,223,231,139,527,206,232,216,101,18,328,3007,1379,1282,2661,346,5,3,51185,1,51
40,1875,"WARWICK",1835,1835,0,0,119,57,66,70,31,103,47,76,86,42,18,1120,1835,343,354,697,1138,5,3,51189,1,51
40,1910,"WASHINGTON",12156,12156,0,0,1974,858,1030,957,593,1925,805,1038,873,528,127,1448,12156,5412,5169,10581,1575,5,3,51191,1,51
40,1930,"WESTMORELAND",8102,8102,0,0,609,266,278,353,196,538,237,354,395,175,621,4080,8102,1702,1699,3401,4701,5,3,51193,1,51
40,1955,"WOOD",3036,3036,0,0,530,201,206,227,163,502,209,231,208,108,1,450,3036,1327,1258,2585,451,5,3,54107,1,51
40,1970,"WYTHE",8356,8356,0,0,1334,626,702,629,421,1406,501,659,585,317,19,1157,8356,3712,3468,7180,1176,5,3,51197,1,51
40,1990,"YORK",5187,5187,0,0,328,127,148,213,95,247,114,204,226,96,458,2931,5187,911,887,1798,3389,5,3,51199,1,51
40,7100,"NORFOLK CITY",9193,9193,9193,0,567,329,598,707,300,573,347,516,595,244,592,3825,9193,2501,2275,4776,4417,5,3,51710,1,51
40,7300,"PETERSBURG",5668,5668,5668,0,285,194,366,415,115,297,131,225,274,102,1089,2175,5668,1375,1029,2404,3264,5,3,51730,1,51
40,7600,"RICHMOND CITY",9735,9735,9735,0,559,326,765,810,267,529,329,521,505,187,1189,3748,9735,2727,2071,4798,4937,5,3,51760,1,51
40,0,"VIRGINIA",974622,974600,24596,0,97777,42919,51473,52567,35302,90715,42207,54899,51163,32512,30570,392518,974622,280038,271496,551534,423088,5,3,51000,2,51
44,90,"BALDWIN",6356,6356,0,0,746,317,518,336,135,658,274,302,313,191,16,2550,6356,2052,1738,3790,2566,5,3,13009,1,13
44,290,"BRYAN",2827,2827,0,0,121,41,38,69,27,91,37,60,51,22,6,2264,2827,296,261,557,2270,5,3,13029,1,13
44,310,"BULLOCH",2305,2305,0,0,387,140,128,175,100,377,165,128,185,76,18,426,2305,930,931,1861,444,5,3,13031,1,13
44,330,"BURKE",10858,10858,0,0,1147,489,639,624,287,1059,456,603,507,280,76,4691,10858,3186,2905,6091,4767,5,3,13033,1,13
44,390,"CAMDEN",3941,3941,0,0,202,81,84,237,67,202,72,103,124,35,47,2687,3941,671,536,1207,2734,5,3,13039,1,13
44,510,"CHATHAM",13540,13540,5215,0,356,217,362,526,207,418,235,322,395,176,578,9748,13540,1668,1546,3214,10326,5,3,13051,1,13
44,590,"CLARKE",7628,7628,0,0,988,426,490,419,268,901,390,492,395,231,34,2594,7628,2591,2409,5000,2628,5,3,13059,1,13
44,730,"COLUMBIA",11242,11242,0,0,894,389,565,491,298,813,457,530,495,297,33,5980,11242,2637,2592,5229,6013,5,3,13073,1,13
44,1030,"EFFINGHAM",2586,2586,0,0,290,145,131,160,104,253,116,139,149,88,1,1010,2586,830,745,1575,1011,5,3,13103,1,13
44,1050,"ELBERT",12156,12156,0,0,1440,627,709,683,423,1404,563,698,628,357,50,4574,12156,3882,3650,7532,4624,5,3,13105,1,13
44,1190,"FRANKLIN",10815,10815,0,0,1883,727,808,767,504,1774,698,859,747,376,16,1656,10815,4689,4454,9143,1672,5,3,13119,1,13
44,1270,"GLYNN",3417,3417,0,0,92,51,48,74,49,88,37,51,53,21,8,2845,3417,314,250,564,2853,5,3,13127,1,13
44,1330,"GREENE",11679,11679,0,0,1222,522,635,661,282,1172,457,672,504,271,45,5236,11679,3322,3076,6398,5281,5,3,13133,1,13
44,1410,"HANCOCK",13330,13330,0,0,1256,595,654,699,371,1224,549,585,585,331,25,6456,13330,3575,3274,6849,6481,5,3,13141,1,13
44,1510,"JACKSON",10569,10569,0,0,1832,709,702,761,420,1766,688,788,709,367,11,1816,10569,4424,4318,8742,1827,5,3,13151,1,13
44,1590,"JASPER/RANDOLPH",7573,7573,0,0,1278,482,666,440,204,1064,467,647,349,146,9,1821,7573,3070,2673,5743,1830,5,3,13159,1,13
44,1630,"JEFFERSON",6111,6111,0,0,606,331,354,353,249,606,326,367,361,193,29,2336,6111,1893,1853,3746,2365,5,3,13163,1,13
44,1690,"JONES",8597,8597,0,0,1143,526,444,661,310,999,419,370,516,183,439,2587,8597,3084,2487,5571,3026,5,3,13169,1,13
44,1750,"LAURENS",2210,2210,0,0,356,174,168,165,69,277,143,149,152,61,11,485,2210,932,782,1714,496,5,3,13175,1,13
44,1790,"LIBERTY",6228,6228,0,0,222,105,124,169,73,225,101,128,128,77,68,4808,6228,693,659,1352,4876,5,3,13179,1,13
44,1810,"LINCOLN",4555,4555,0,0,459,198,247,235,130,439,198,148,180,97,12,2212,4555,1269,1062,2331,2224,5,3,13181,1,13
44,1910,"MCINTOSH",3739,3739,0,0,102,70,59,91,64,128,55,77,70,45,21,2957,3739,386,375,761,2978,5,3,13191,1,13
44,2090,"MONTGOMERY",2954,2954,0,0,448,195,197,202,113,401,154,194,181,105,17,747,2954,1155,1035,2190,764,5,3,13209,1,13
44,2110,"MORGAN",8369,8369,0,0,1310,443,456,646,230,1243,435,490,515,181,2,2418,8369,3085,2864,5949,2420,5,3,13211,1,13
44,2210,"OGLETHORPE",12297,12297,0,0,1277,481,694,668,386,1283,506,683,551,328,5,5435,12297,3506,3351,6857,5440,5,3,13221,1,13
44,2350,"PULASKI",2093,2093,0,0,321,110,153,152,79,305,121,139,118,55,12,528,2093,815,738,1553,540,5,3,13235,1,13
44,2370,"PUTNAM",10029,10029,0,0,1373,515,682,678,304,1285,502,610,576,246,38,3220,10029,3552,3219,6771,3258,5,3,13237,1,13
44,2450,"RICHMOND",6189,6189,0,0,406,225,346,333,171,374,180,264,240,142,72,3436,6189,1481,1200,2681,3508,5,3,13245,1,13
44,2510,"SCREVEN",4477,4477,0,0,499,200,273,262,154,462,200,242,236,129,4,1816,4477,1388,1269,2657,1820,5,3,13251,1,13
44,2670,"TATTNALL",2206,2206,0,0,350,119,122,158,86,301,140,123,151,50,64,542,2206,835,765,1600,606,5,3,13267,1,13
44,2710,"TELFAIR",744,744,0,0,107,41,54,60,27,87,37,49,41,22,1,218,744,289,236,525,219,5,3,13271,1,13
44,2890,"TWIGGS",3405,3405,0,0,588,181,248,272,145,540,183,285,197,117,7,642,3405,1434,1322,2756,649,5,3,13289,1,13
44,2970,"WALTON",1026,1026,0,0,186,74,84,76,60,186,79,102,73,44,2,60,1026,480,484,964,62,5,3,13297,1,13
44,3010,"WARREN",8725,8725,0,0,1117,514,502,534,272,1036,482,477,472,253,18,3048,8725,2939,2720,5659,3066,5,3,13301,1,13
44,3030,"WASHINGTON",9940,9940,0,0,1184,636,752,586,230,1121,534,606,564,210,4,3513,9940,3388,3035,6423,3517,5,3,13303,1,13
44,3050,"WAYNE",676,676,0,0,82,46,29,40,30,66,28,45,37,18,1,254,676,227,194,421,255,5,3,13305,1,13
44,3170,"WILKES",14887,14887,0,0,1355,582,751,738,428,1356,597,783,645,367,1,7284,14887,3854,3748,7602,7285,5,3,13317,1,13
44,3190,"WILKINSON",2154,2154,0,0,377,227,169,171,79,299,156,151,157,50,0,318,2154,1023,813,1836,318,5,3,13319,1,13
44,0,"GEORGIA",252433,252433,5215,0,28002,11951,14085,14372,7435,26283,11237,13461,12350,6238,1801,105218,252433,75845,69569,145414,107019,5,3,13000,2,13
45,50,"ASCENSION",2219,2219,0,0,221,76,104,159,60,208,78,89,104,42,47,1031,2219,620,521,1141,1078,6,4,22005,1,22
45,70,"ASSUMPTION",2472,2472,0,0,357,175,176,219,80,338,171,180,158,61,10,547,2472,1007,908,1915,557,6,4,22007,1,22
45,90,"AVOYELLES",1209,1209,0,0,157,58,60,111,33,131,81,74,68,10,22,404,1209,419,364,783,426,6,4,22009,1,22
45,250,"CATAHOULA",1164,1164,0,0,159,69,98,120,33,127,52,59,76,15,8,348,1164,479,329,808,356,6,4,22025,1,22
45,290,"CONCORDIA",2895,2895,0,0,188,77,156,243,75,220,84,85,116,35,35,1581,2895,739,540,1279,1616,6,4,22029,1,22
45,470,"IBERVILLE",2679,2679,0,0,244,93,167,199,83,238,100,136,100,69,45,1205,2679,786,643,1429,1250,6,4,22047,1,22
45,570,"LAFOURCHE",1995,1995,0,0,317,159,151,154,108,310,130,135,163,64,15,289,1995,889,802,1691,304,6,4,22057,1,22
45,690,"NATCHITOCHES",2870,2870,0,0,191,80,22,264,124,172,91,103,108,58,181,1476,2870,681,532,1213,1657,6,4,22069,1,22
45,710,"ORLEANS",24552,24552,17242,0,914,448,609,1623,941,934,537,666,868,461,5727,10824,24552,4535,3466,8001,16551,6,4,22071,1,22
45,730,"OUACHITA",1077,1077,0,0,131,46,72,140,50,150,47,65,58,25,9,284,1077,439,345,784,293,6,4,22073,1,22
45,750,"PLAQUEMINES",1549,1549,0,0,117,41,61,70,38,79,40,41,47,23,239,753,1549,327,230,557,992,6,4,22075,1,22
45,770,"POINTE COUPEE",4539,4539,0,0,208,82,105,197,90,212,103,106,100,45,104,3187,4539,682,566,1248,3291,6,4,22077,1,22
45,790,"RAPIDES",2200,2200,0,0,181,91,74,127,53,186,83,89,84,28,123,1081,2200,526,470,996,1204,6,4,22079,1,22
45,870,"ST BERNARD",1020,1020,0,0,104,51,92,46,44,110,59,72,29,21,10,382,1020,337,291,628,392,6,4,22087,1,22
45,890,"ST CHARLES",3291,3291,0,0,157,56,74,97,67,110,81,72,62,44,150,2321,3291,451,369,820,2471,6,4,22089,1,22
45,930,"ST JAMES",3955,3955,0,0,403,176,152,224,101,350,179,133,161,83,41,1952,3955,1056,906,1962,1993,6,4,22093,1,22
45,950,"ST JOHN THE BAPTIST",2990,2990,0,0,290,119,98,158,84,257,113,111,116,56,70,1518,2990,749,653,1402,1588,6,4,22095,1,22
45,970,"OPELOUSAS",5048,5048,0,0,577,257,279,378,205,462,224,265,245,97,389,1670,5048,1696,1293,2989,2059,6,4,22097,1,22
45,990,"ATTAKAPAS",7369,7369,0,0,812,278,354,510,191,662,278,330,304,240,278,3132,7369,2145,1814,3959,3410,6,4,22099,1,22
45,1210,"WEST BATON ROUGE",1463,1463,0,0,120,59,59,91,48,128,57,63,59,22,82,675,1463,377,329,706,757,6,4,22121,1,22
45,0,"LOUISIANA/ORLEANS",76556,76556,17242,0,5848,2491,2963,5130,2508,5384,2588,2874,3026,1499,7585,34660,76556,18940,15371,34311,42245,6,4,22000,2,22
46,10,"ADAMS",10002,10002,0,0,599,269,571,738,243,636,289,439,356,115,76,5671,10002,2420,1835,4255,5747,6,4,28001,1,28
46,50,"AMITE",4750,4750,0,0,698,229,334,419,164,607,217,284,252,108,16,1422,4750,1844,1468,3312,1438,6,4,28005,1,28
46,210,"CLAIBORNE",3102,3102,0,0,239,125,217,244,74,242,106,170,102,33,12,1538,3102,899,653,1552,1550,6,4,28021,1,28
46,370,"FRANKLIN",2016,2016,0,0,235,107,146,158,65,233,87,105,90,42,13,735,2016,711,557,1268,748,6,4,28037,1,28
46,630,"JEFFERSON",4001,4001,0,0,436,149,247,304,114,370,149,216,137,67,20,1792,4001,1250,939,2189,1812,6,4,28063,1,28
46,890,"MADISON",4699,4699,0,0,792,260,348,397,159,768,256,353,289,123,6,948,4699,1956,1789,3745,954,6,4,28089,1,28
46,1490,"WARREN",1114,1114,0,0,111,42,80,101,23,116,32,57,39,21,19,473,1114,357,265,622,492,6,4,28149,1,28
46,1530,"WAYNE",1253,1253,0,0,199,77,108,111,52,161,72,74,83,35,19,262,1253,547,425,972,281,6,4,28153,1,28
46,1570,"WILKINSON",5068,5068,0,0,403,173,295,344,126,453,149,244,180,65,6,2630,5068,1341,1091,2432,2636,6,4,28157,1,28
46,8810,"BALDWIN",1427,1427,0,0,124,46,80,91,34,102,53,52,68,17,43,717,1427,375,292,667,760,6,4,1003,1,28
46,8830,"WASHINGTON",2920,2920,0,0,381,160,266,253,90,327,134,193,157,49,10,900,2920,1150,860,2010,910,6,4,1129,1,28
46,0,"MISSISSIPPI",40352,40352,0,0,4217,1637,2692,3160,1144,4015,1544,2187,1753,675,240,17088,40352,12850,10174,23024,17328,6,4,28000,2,28
47,70,"ANSON",8831,8831,0,0,1411,573,629,607,315,1202,537,519,325,300,88,2325,8831,3535,2883,6418,2413,5,3,37007,1,37
47,90,"ASHE",3694,3694,0,0,737,297,370,224,180,716,274,345,253,145,6,147,3694,1808,1733,3541,153,5,3,37009,1,37
47,130,"BEAUFORT",7203,7203,0,0,681,345,408,460,260,709,342,452,450,262,266,2568,7203,2154,2215,4369,2834,5,3,37013,1,37
47,150,"BERTIE",11218,11218,0,0,822,346,470,517,260,784,350,581,545,270,214,6059,11218,2415,2530,4945,6273,5,3,37015,1,37
47,170,"BLADEN",5671,5671,0,0,638,278,441,352,154,583,414,287,230,195,114,1985,5671,1863,1709,3572,2099,5,3,37017,1,37
47,190,"BRUNSWICK",4778,4778,0,0,422,210,156,256,129,382,227,173,234,125,210,2254,4778,1173,1141,2314,2464,5,3,37019,1,37
47,210,"BUNCOMBE",9277,9277,0,0,1835,671,728,690,480,1686,613,778,692,391,18,695,9277,4404,4160,8564,713,5,3,37021,1,37
47,230,"BURKE",11007,11007,0,0,1919,822,832,761,542,1759,783,889,733,474,60,1433,11007,4876,4638,9514,1493,5,3,37023,1,37
47,250,"CABARRUS",6158,6158,0,0,875,404,513,445,247,906,398,520,400,213,3,1234,6158,2484,2437,4921,1237,5,3,37025,1,37
47,290,"CAMDEN",5347,5347,0,0,706,317,330,401,196,691,322,380,377,168,48,1411,5347,1950,1938,3888,1459,5,3,37029,1,37
47,310,"CARTERET",4823,4823,0,0,663,280,302,327,206,558,239,376,373,221,106,1172,4823,1778,1767,3545,1278,5,3,37031,1,37
47,330,"CASWELL",11757,11757,0,0,1401,604,643,683,378,1318,609,727,652,353,90,4299,11757,3709,3659,7368,4389,5,3,37033,1,37
47,370,"CHATHAM",12977,12977,0,0,1716,717,823,851,502,1639,651,892,802,507,242,3635,12977,4609,4491,9100,3877,5,3,37037,1,37
47,410,"CHOWAN",5297,5297,0,0,366,186,228,266,140,362,207,251,272,131,99,2789,5297,1186,1223,2409,2888,5,3,37041,1,37
47,470,"COLUMBUS",3022,3022,0,0,417,191,144,114,215,446,211,260,200,94,27,703,3022,1081,1211,2292,730,5,3,37047,1,37
47,490,"CRAVEN",12676,12676,0,0,1020,521,628,596,369,939,544,687,695,502,1125,5050,12676,3134,3367,6501,6175,5,3,37049,1,37
47,510,"CUMBERLAND",9382,9382,0,0,1150,440,563,641,459,1013,482,633,652,458,95,2796,9382,3253,3238,6491,2891,5,3,37051,1,37
47,530,"CURRITUCK",6985,6985,0,0,941,448,432,536,281,841,472,565,483,235,120,1631,6985,2638,2596,5234,1751,5,3,37053,1,37
47,610,"DUPLIN",7863,7863,0,0,1036,441,495,505,307,842,446,514,496,336,29,2416,7863,2784,2634,5418,2445,5,3,37061,1,37
47,650,"EDGECOMBE",12423,12423,0,0,1240,534,683,689,388,1166,512,756,700,411,237,5107,12423,3534,3545,7079,5344,5,3,37065,1,37
47,690,"FRANKLIN",10166,10166,0,0,786,400,487,430,239,760,449,494,382,238,171,5330,10166,2342,2323,4665,5501,5,3,37069,1,37
47,730,"GATES",5965,5965,0,0,560,261,287,285,175,489,233,312,281,179,113,2790,5965,1568,1494,3062,2903,5,3,37073,1,37
47,770,"GRANVILLE",15576,15576,0,0,1337,534,684,745,446,1255,536,727,659,440,467,7746,15576,3746,3617,7363,8213,5,3,37077,1,37
47,790,"GREENE",4867,4867,0,0,521,219,260,274,138,517,250,323,327,141,55,1842,4867,1412,1558,2970,1897,5,3,37079,1,37
47,810,"GUILFORD",11420,11420,0,0,1066,937,999,899,646,1974,767,1042,895,625,103,1467,11420,4547,5303,9850,1570,5,3,37081,1,37
47,830,"HALIFAX",13620,13620,0,0,1018,412,557,585,325,911,416,582,601,353,1236,6624,13620,2897,2863,5760,7860,5,3,37083,1,37
47,870,"HAYWOOD",2780,2780,0,0,573,219,223,219,132,493,205,237,209,92,7,171,2780,1366,1236,2602,178,5,3,37087,1,37
47,910,"HERTFORD",6052,6052,0,0,505,231,304,357,120,485,214,320,272,135,304,2805,6052,1517,1426,2943,3109,5,3,37091,1,37
47,950,"HYDE",6029,6029,0,0,663,291,339,346,190,662,631,401,398,166,90,1852,6029,1829,2258,4087,1942,5,3,37095,1,37
47,970,"IREDELL",10972,10972,0,0,1570,663,782,749,548,1479,616,863,816,449,5,2432,10972,4312,4223,8535,2437,5,3,37097,1,37
47,1010,"JOHNSTON",6867,6867,0,0,827,379,378,446,243,784,368,440,413,231,28,2330,6867,2273,2236,4509,2358,5,3,37101,1,37
47,1030,"JONES",4968,4968,0,0,458,178,252,260,119,401,170,265,243,156,91,2375,4968,1267,1235,2502,2466,5,3,37103,1,37
47,1070,"LENOIR",5572,5572,0,0,573,216,278,272,168,496,206,317,305,188,113,2440,5572,1507,1512,3019,2553,5,3,37107,1,37
47,1090,"LINCOLN",16359,16359,0,0,2739,1170,1295,1120,746,2497,1113,1347,1173,662,8,2489,16359,7070,6792,13862,2497,5,3,37109,1,37
47,1170,"MARTIN",5987,5987,0,0,662,277,312,328,204,537,320,352,339,184,115,2357,5987,1783,1732,3515,2472,5,3,37117,1,37
47,1190,"MECKLENBURG",14272,14272,0,0,1985,855,999,966,595,1955,787,1071,975,556,34,3494,14272,5400,5344,10744,3528,5,3,37119,1,37
47,1230,"MONTGOMERY",8430,8430,0,0,1339,576,564,531,406,1275,520,643,509,337,34,1696,8430,3416,3284,6700,1730,5,3,37123,1,37
47,1250,"MOORE",6367,6367,0,0,990,415,506,476,305,978,420,466,509,302,56,944,6367,2692,2675,5367,1000,5,3,37125,1,37
47,1270,"NASH",7268,7268,0,0,717,245,421,422,225,672,328,470,513,231,127,2897,7268,2030,2214,4244,3024,5,3,37127,1,37
47,1290,"NEW HANOVER",11465,11465,0,0,589,366,585,569,219,788,480,586,504,205,132,6442,11465,2328,2563,4891,6574,5,3,37129,1,37
47,1310,"NORTHAMPTON",13082,13082,0,0,859,395,548,504,294,822,374,592,504,352,580,7258,13082,2600,2644,5244,7838,5,3,37131,1,37
47,1330,"ONSLOW",6669,6669,0,0,751,322,408,401,261,656,316,480,464,270,41,2299,6669,2143,2186,4329,2340,5,3,37133,1,37
47,1350,"ORANGE",20135,20135,0,0,2872,1247,1365,1215,1008,2707,1129,1579,1109,871,332,4701,20135,7707,7395,15102,5033,5,3,37135,1,37
47,1390,"PASQUOTANK",7674,7674,0,0,872,414,413,508,170,814,392,479,544,223,550,2295,7674,2377,2452,4829,2845,5,3,37139,1,37
47,1430,"PERQUIMANS",6052,6052,0,0,690,326,374,367,181,668,285,430,388,207,119,2017,6052,1938,1978,3916,2136,5,3,37143,1,37
47,1450,"PERSON",6642,6642,0,0,796,328,351,385,225,688,300,396,315,203,82,2573,6642,2085,1902,3987,2655,5,3,37145,1,37
47,1470,"PITT",9169,9169,0,0,919,456,477,575,317,896,418,575,535,412,0,3589,9169,2744,2836,5580,3589,5,3,37147,1,37
47,1510,"RANDOLPH",10112,10112,0,0,1690,752,631,875,450,1582,938,807,925,459,205,798,10112,4398,4711,9109,1003,5,3,37151,1,37
47,1530,"RICHMOND",6695,6695,0,0,1037,413,422,475,346,975,380,503,502,319,22,1301,6695,2693,2679,5372,1323,5,3,37153,1,37
47,1550,"ROBESON",7528,7528,0,0,976,489,520,509,387,946,428,593,551,372,417,1340,7528,2881,2890,5771,1757,5,3,37155,1,37
47,1570,"ROCKINGHAM",10316,10316,0,0,1579,653,751,752,468,1381,551,886,665,473,43,2114,10316,4203,3956,8159,2157,5,3,37157,1,37
47,1590,"ROWAN",21543,21543,0,0,3224,1488,1791,1529,949,3062,1467,1874,1439,874,89,3757,21543,8981,8716,17697,3846,5,3,37159,1,37
47,1610,"RUTHERFORD",13202,13202,0,0,2564,987,1049,1006,683,2335,915,1201,899,545,39,979,13202,6289,5895,12184,1018,5,3,37161,1,37
47,1630,"SAMPSON",6620,6620,0,0,905,373,459,385,265,756,374,450,384,211,9,2049,6620,2387,2175,4562,2058,5,3,37163,1,37
47,1690,"STOKES",11645,11645,0,0,1813,815,887,860,586,1665,824,984,851,492,122,1746,11645,4961,4816,9777,1868,5,3,37169,1,37
47,1710,"SURRY",10366,10366,0,0,954,837,902,799,569,1778,679,929,804,562,84,1469,10366,4061,4752,8813,1553,5,3,37171,1,37
47,1770,"TYRRELL",3364,3364,0,0,430,181,229,227,124,399,209,257,241,123,34,910,3364,1191,1229,2420,944,5,3,37177,1,37
47,1830,"WAKE",17086,17086,0,0,1947,823,927,992,598,1894,814,1071,976,647,519,5878,17086,5287,5402,10689,6397,5,3,37183,1,37
47,1850,"WARREN",11004,11004,0,0,761,356,368,441,288,705,403,439,439,291,231,6282,11004,2214,2277,4491,6513,5,3,37185,1,37
47,1870,"WASHINGTON",3464,3464,0,0,352,137,189,241,98,332,161,228,249,127,63,1287,3464,1017,1097,2114,1350,5,3,37187,1,37
47,1910,"WAYNE",8687,8687,0,0,1102,467,512,602,254,986,440,565,596,296,111,2756,8687,2937,2883,5820,2867,5,3,37191,1,37
47,1930,"WILKES",9054,9054,0,0,1469,593,727,608,471,1424,594,772,677,437,88,1194,9054,3868,3904,7772,1282,5,3,37193,1,37
47,0,"NORTH CAROLINA",555500,555500,0,0,68036,30321,34630,34456,21189,65421,30053,37933,33944,20427,10266,168824,555500,188632,187778,376410,179090,5,3,37000,2,37
48,10,"ABBEVILLE",21156,21156,0,0,2681,1183,1408,1393,683,2519,1050,1481,1362,636,88,6672,21156,7348,7048,14396,6760,5,3,45001,1,45
48,110,"BARNWELL",12280,12280,0,0,1580,654,757,698,407,1464,622,768,639,380,158,4153,12280,4096,3873,7969,4311,5,3,45011,1,45
48,130,"BEAUFORT",25887,25887,0,0,878,398,404,614,197,786,361,466,527,161,181,20914,25887,2491,2301,4792,21095,5,3,45013,1,45
48,190,"CHARLESTON",63179,63179,24711,0,2036,1128,2016,2195,942,2327,1215,1275,1844,1033,1783,45385,63179,8317,7694,16011,47168,5,3,45019,1,45
48,230,"CHESTER",11479,11479,0,0,1460,677,827,867,508,1470,681,960,793,479,14,2743,11479,4339,4383,8722,2757,5,3,45023,1,45
48,250,"CHESTERFIELD",5564,5564,0,0,750,306,338,324,233,663,327,400,322,204,58,1639,5564,1951,1916,3867,1697,5,3,45025,1,45
48,290,"COLLETON",26359,26359,0,0,805,476,389,508,166,702,361,338,438,107,211,21858,26359,2344,1946,4290,22069,5,3,45029,1,45
48,310,"DARLINGTON",9047,9047,0,0,1171,540,561,508,317,1289,507,542,537,287,57,2731,9047,3097,3162,6259,2788,5,3,45031,1,45
48,370,"EDGEFIELD",23160,23160,0,0,2697,1251,1380,1292,720,2631,1103,1380,1251,728,151,8576,23160,7340,7093,14433,8727,5,3,45037,1,45
48,390,"FAIRFIELD",11857,11857,0,0,1368,670,935,646,530,1223,618,756,599,441,37,4034,11857,4149,3637,7786,4071,5,3,45039,1,45
48,430,"GEORGETOWN",15679,15679,0,0,264,128,166,241,100,233,125,187,191,75,102,13867,15679,899,811,1710,13969,5,3,45043,1,45
48,450,"GREENVILLE",13133,13133,0,0,2168,887,1007,818,578,1989,870,991,908,523,41,2353,13133,5458,5281,10739,2394,5,3,45045,1,45
48,510,"HORRY",4349,4349,0,0,538,218,265,284,167,512,230,234,309,176,18,1398,4349,1472,1461,2933,1416,5,3,45051,1,45
48,550,"KERSHAW",9867,9867,0,0,913,432,452,467,313,813,384,463,424,281,78,4847,9867,2577,2365,4942,4925,5,3,45055,1,45
48,570,"LANCASTER",6318,6318,0,0,765,376,432,433,242,752,290,387,401,222,372,1646,6318,2248,2052,4300,2018,5,3,45057,1,45
48,590,"LAURENS",14982,14982,0,0,2259,868,1105,1077,539,2201,881,1176,1008,531,29,3308,14982,5848,5797,11645,3337,5,3,45059,1,45
48,630,"LEXINGTON",6641,6641,0,0,922,379,428,421,235,873,310,502,379,264,17,1911,6641,2385,2328,4713,1928,5,3,45063,1,45
48,670,"MARION",8884,8884,0,0,1136,512,552,526,301,1137,410,566,559,320,94,2771,8884,3027,2992,6019,2865,5,3,45067,1,45
48,690,"MARLBORO",4966,4966,0,0,624,237,277,283,132,587,251,273,259,250,84,1709,4966,1553,1620,3173,1793,5,3,45069,1,45
48,710,"NEWBERRY",13964,13964,0,0,1884,833,1055,868,483,1730,740,961,831,463,110,4006,13964,5123,4725,9848,4116,5,3,45071,1,45
48,750,"ORANGEBURG",13229,13229,0,0,1272,573,587,642,342,1150,558,623,553,339,26,6564,13229,3416,3223,6639,6590,5,3,45075,1,45
48,755,"PENDLETON",22897,22897,0,0,3946,1647,1758,1645,1006,3523,1670,1867,1422,880,48,3485,22897,10002,9362,19364,3533,5,3,45075.1,1,45
48,790,"RICHLAND",9027,9027,0,0,607,297,340,340,179,591,258,363,274,219,321,5238,9027,1763,1705,3468,5559,5,3,45079,1,45
48,830,"SPARTANBURG",14259,14259,0,0,2332,962,1136,964,653,2040,929,1214,998,607,33,2391,14259,6047,5788,11835,2424,5,3,45083,1,45
48,850,"SUMTER",19054,19054,0,0,1350,526,667,789,360,1247,522,683,620,364,288,11638,19054,3692,3436,7128,11926,5,3,45085,1,45
48,870,"UNION",10995,10995,0,0,1640,316,804,762,411,1566,680,819,682,401,68,2846,10995,3933,4148,8081,2914,5,3,45087,1,45
48,890,"WILLIAMSBURG",6871,6871,0,0,399,177,210,266,141,373,166,219,217,138,47,4518,6871,1193,1113,2306,4565,5,3,45089,1,45
48,910,"YORK",10032,10032,0,0,1224,542,677,617,419,1106,510,689,627,417,40,3164,10032,3479,3349,6828,3204,5,3,45091,1,45
48,0,"SOUTH CAROLINA",415115,415115,24711,0,39669,17193,20933,20488,11304,37497,16629,20583,18974,10926,4554,196365,415115,109587,104609,214196,200919,5,3,45000,2,45
51,10,"ADAIR",6011,6011,0,0,1038,383,520,434,261,951,385,491,364,223,5,956,6011,2636,2414,5050,961,6,4,21001,1,21
51,90,"BARREN",11286,11286,0,0,1931,759,853,858,506,1909,744,838,717,437,10,1724,11286,4907,4645,9552,1734,6,4,21009,1,21
51,150,"BOONE",3608,3608,0,0,506,419,231,460,117,529,207,156,203,96,28,656,3608,1733,1191,2924,684,6,4,21015,1,21
51,170,"BOURBON",18009,18009,0,0,2668,1088,1324,1209,778,2445,1028,1395,1083,632,190,4169,18009,7067,6583,13650,4359,6,4,21017,1,21
51,230,"BRACKEN",3706,3706,0,0,656,291,296,274,198,614,270,298,259,161,31,358,3706,1715,1602,3317,389,6,4,21023,1,21
51,270,"BRECKINRIDGE",3430,3430,0,0,638,233,236,282,140,580,214,266,227,103,6,505,3430,1529,1390,2919,511,6,4,21027,1,21
51,290,"BULLITT",4311,4311,0,0,628,268,281,335,205,594,256,339,258,157,14,976,4311,1717,1604,3321,990,6,4,21029,1,21
51,310,"BUTLER",2181,2181,0,0,385,126,171,198,90,387,127,193,151,71,8,274,2181,970,929,1899,282,6,4,21031,1,21
51,330,"CALDWELL",4268,4268,0,0,769,369,408,370,111,676,324,354,254,50,4,579,4268,2027,1658,3685,583,6,4,21033,1,21
51,370,"CAMPBELL",3473,3473,0,0,592,220,297,319,171,540,236,274,233,109,10,472,3473,1599,1392,2991,482,6,4,21037,1,21
51,450,"CASEY",3285,3285,0,0,633,243,248,267,172,600,220,278,245,133,4,242,3285,1563,1476,3039,246,6,4,21045,1,21
51,470,"CHRISTIAN",11020,11020,0,0,1884,793,794,932,431,1800,696,719,850,336,19,1766,11020,4834,4401,9235,1785,6,4,21047,1,21
51,490,"CLARK",11519,11519,0,0,1732,686,769,766,451,1596,710,782,702,368,23,2934,11519,4404,4158,8562,2957,6,4,21049,1,21
51,510,"CLAY",2398,2398,0,0,542,159,243,152,106,502,133,199,152,69,0,141,2398,1202,1055,2257,141,6,4,21051,1,21
51,570,"CUMBERLAND",6191,6191,0,0,1101,430,469,500,230,1072,364,466,450,184,3,922,6191,2730,2536,5266,925,6,4,21057,1,21
51,650,"ESTILL",2082,2082,0,0,440,152,173,163,97,400,127,177,144,75,1,133,2082,1025,923,1948,134,6,4,21065,1,21
51,670,"FAYETTE",21370,21370,4326,0,2410,1088,1370,1195,785,2408,1087,1327,1164,664,208,7664,21370,6848,6650,13498,7872,6,4,21067,1,21
51,690,"FLEMING",8947,8947,0,0,1754,710,720,718,458,1661,610,702,711,337,17,549,8947,4360,4021,8381,566,6,4,21069,1,21
51,710,"FLOYD",3485,3485,0,0,759,298,298,277,177,649,234,286,254,138,0,115,3485,1809,1561,3370,115,6,4,21071,1,21
51,730,"FRANKLIN",8013,8013,0,0,1101,464,602,587,298,1024,431,529,463,257,56,2201,8013,3052,2704,5756,2257,6,4,21073,1,21
51,770,"GALLATIN",3307,3307,0,0,530,222,260,252,129,481,190,223,229,91,12,688,3307,1393,1214,2607,700,6,4,21077,1,21
51,790,"GARRARD",9186,9186,0,0,1320,611,670,587,404,1279,625,682,569,341,15,2083,9186,3592,3496,7088,2098,6,4,21079,1,21
51,850,"GRAYSON",2301,2301,0,0,482,183,211,182,101,430,153,208,153,95,0,103,2301,1159,1039,2198,103,6,4,21085,1,21
51,870,"GREEN",6735,6735,0,0,1098,424,486,428,284,993,422,475,426,229,69,1401,6735,2720,2545,5265,1470,6,4,21087,1,21
51,890,"GREENUP",2369,2369,0,0,394,160,182,232,71,360,118,155,154,48,11,484,2369,1039,835,1874,495,6,4,21089,1,21
51,930,"HARDIN",7531,7531,0,0,1316,508,661,467,362,1332,531,575,562,249,28,940,7531,3314,3249,6563,968,6,4,21093,1,21
51,970,"HARRISON",7752,7752,0,0,1199,703,663,535,272,1316,671,565,487,227,9,1105,7752,3372,3266,6638,1114,6,4,21097,1,21
51,1010,"HENDERSON",4703,4703,0,0,637,253,272,352,166,601,218,309,245,116,20,1514,4703,1680,1489,3169,1534,6,4,21101,1,21
51,1030,"HENRY",6777,6777,0,0,1319,444,347,571,342,1035,462,384,538,187,11,1137,6777,3023,2606,5629,1148,6,4,21103,1,21
51,1070,"HOPKINS",2964,2964,0,0,540,203,246,247,119,470,210,233,201,82,1,412,2964,1355,1196,2551,413,6,4,21107,1,21
51,1110,"JEFFERSON",13399,13399,0,0,1739,707,868,895,496,1636,676,803,761,357,114,4347,13399,4705,4233,8938,4461,6,4,21111,1,21
51,1130,"JESSAMINE",8377,8377,0,0,1159,467,584,495,367,1043,435,594,436,278,36,2483,8377,3072,2786,5858,2519,6,4,21113,1,21
51,1210,"KNOX",5875,5875,0,0,1194,435,473,488,277,1101,394,497,451,218,40,307,5875,2867,2661,5528,347,6,4,21121,1,21
51,1350,"LEWIS",2357,2357,0,0,420,223,242,143,169,365,186,149,129,46,1,284,2357,1197,875,2072,285,6,4,21135,1,21
51,1370,"LINCOLN",8676,8676,0,0,1232,506,603,593,362,1081,494,613,534,289,28,2341,8676,3296,3011,6307,2369,6,4,21137,1,21
51,1390,"LIVINGSTON",3674,3674,0,0,577,236,303,329,152,538,223,233,225,116,24,718,3674,1597,1335,2932,742,6,4,21139,1,21
51,1410,"LOGAN",12123,12123,0,0,1945,960,805,845,452,1702,964,725,739,331,169,2486,12123,5007,4461,9468,2655,6,4,21141,1,21
51,1510,"MADISON",15540,15540,0,0,2531,1033,1182,1071,687,2251,968,1212,1013,533,22,3037,15540,6504,5977,12481,3059,6,4,21151,1,21
51,1610,"MASON",12459,12459,0,0,1937,815,934,883,615,1771,827,929,801,480,45,2422,12459,5184,4808,9992,2467,6,4,21161,1,21
51,1670,"MERCER",12630,12630,0,0,1722,812,824,863,546,1681,684,853,818,487,56,3284,12630,4767,4523,9290,3340,6,4,21167,1,21
51,1730,"MONTGOMERY",12975,12975,0,0,2341,865,950,896,580,2486,870,993,722,468,37,1767,12975,5632,5539,11171,1804,6,4,21173,1,21
51,1770,"MUHLENBERG",4181,4181,0,0,798,317,296,337,178,699,303,355,293,122,3,480,4181,1926,1772,3698,483,6,4,21177,1,21
51,1790,"NELSON",14078,14078,0,0,2149,815,1089,912,650,1967,843,1075,883,557,28,3110,14078,5615,5325,10940,3138,6,4,21179,1,21
51,1810,"NICHOLAS",4898,4898,0,0,876,381,387,377,236,785,350,440,354,182,21,509,4898,2257,2111,4368,530,6,4,21181,1,21
51,1830,"OHIO",3792,3792,0,0,736,236,282,317,151,638,224,291,261,109,14,533,3792,1722,1523,3245,547,6,4,21183,1,21
51,1910,"PENDLETON",3061,3061,0,0,538,203,223,247,188,509,200,250,210,106,1,386,3061,1399,1275,2674,387,6,4,21191,1,21
51,1990,"PULASKI",6897,6897,0,0,1346,532,634,559,345,1154,497,571,511,280,0,468,6897,3416,3013,6429,468,6,4,21199,1,21
51,2030,"ROCKCASTLE",1731,1731,0,0,317,128,114,171,77,318,120,126,137,60,0,163,1731,807,761,1568,163,6,4,21203,1,21
51,2090,"SCOTT",12419,12419,0,0,1611,702,726,1053,531,1510,676,744,699,347,88,3732,12419,4623,3976,8599,3820,6,4,21209,1,21
51,2110,"SHELBY",14877,14877,0,0,2455,952,1023,1105,618,2210,888,1083,955,432,42,3114,14877,6153,5568,11721,3156,6,4,21211,1,21
51,2270,"WARREN",11937,11937,0,0,2202,836,929,924,481,2031,805,949,828,437,17,1498,11937,5372,5050,10422,1515,6,4,21227,1,21
51,2290,"WASHINGTON",13248,13248,0,0,2075,861,991,842,643,1992,1224,1020,828,505,22,2245,13248,5412,5569,10981,2267,6,4,21229,1,21
51,2310,"WAYNE",5430,5430,0,0,1107,455,421,475,329,946,423,478,400,166,0,230,5430,2787,2413,5200,230,6,4,21231,1,21
51,2390,"WOODFORD",9659,9659,0,0,1125,442,583,584,380,1128,466,650,484,311,92,3414,9659,3114,3039,6153,3506,6,4,21239,1,21
51,0,"KENTUCKY",406511,406511,4326,0,65134,26804,29772,29553,17542,60776,25743,29511,25920,13482,1713,80561,406511,168805,155432,324237,82274,6,4,21000,2,21
52,10,"ALLEGANY",6909,6909,0,0,1141,543,566,532,451,1063,490,574,513,303,113,620,6909,3233,2943,6176,733,5,3,24001,1,24
52,30,"ANNE ARUNDEL",26668,26668,0,0,2109,1051,1124,1278,898,2001,992,1266,1160,560,2536,11693,26668,6460,5979,12439,14229,5,3,24003,1,24
52,50,"BALTIMORE",29255,29255,0,0,3532,1638,1838,2144,1548,3261,1643,2166,1883,1368,1537,6697,29255,10700,10321,21021,8234,5,3,24005,1,24
52,70,"CALVERT",8005,8005,0,0,611,277,359,383,211,519,264,424,415,217,388,3937,8005,1841,1839,3680,4325,5,3,24009,1,24
52,90,"CAROLINE",9453,9453,0,0,1264,558,646,754,317,1125,458,703,764,343,1001,1520,9453,3539,3393,6932,2521,5,3,24011,1,24
52,130,"CECIL",13066,13066,0,0,1554,753,914,1055,760,1421,721,919,912,643,947,2467,13066,5036,4616,9652,3414,5,3,24015,1,24
52,150,"CHARLES",20245,20245,0,0,1172,610,634,818,434,991,603,874,810,452,412,12435,20245,3668,3730,7398,12847,5,3,24017,1,24
52,170,"DORCHESTER",18108,18108,0,0,1679,970,1012,989,544,1515,966,1082,1076,582,2661,5032,18108,5194,5221,10415,7693,5,3,24019,1,24
52,190,"FREDERICK",34437,34437,0,0,4720,2181,2749,2692,1924,4580,2152,2699,2562,1724,783,5671,34437,14266,13717,27983,6454,5,3,24021,1,24
52,230,"HARFORD",21258,21258,0,0,2430,1385,1276,1294,1065,2285,1323,1330,1188,1030,2221,4431,21258,7450,7156,14606,6652,5,3,24025,1,24
52,270,"KENT",11450,11450,0,0,810,384,463,668,330,745,329,556,622,315,1979,4249,11450,2655,2567,5222,6228,5,3,24029,1,24
52,290,"MONTGOMERY",17980,17980,0,0,1497,880,948,939,683,1512,821,969,860,622,677,7572,17980,4947,4784,9731,8249,5,3,24031,1,24
52,310,"PRINCE GEORGES",20589,20589,0,0,1030,489,558,604,540,1008,492,636,643,471,4929,9189,20589,3221,3250,6471,14118,5,3,24033,1,24
52,330,"QUEEN ANNES",16648,16648,0,0,1365,583,761,831,470,1209,558,724,586,442,2738,6381,16648,4010,3519,7529,9119,5,3,24035,1,24
52,350,"SOMERSET",17195,17195,0,0,1618,622,764,880,632,1374,619,970,1028,655,1058,6975,17195,4516,4646,9162,8033,5,3,24039,1,24
52,370,"ST MARYS",12794,12794,0,0,983,488,514,584,438,931,431,659,677,453,636,6000,12794,3007,3151,6158,6636,5,3,24037,1,24
52,390,"TALBOT",14230,14230,0,0,1210,537,632,768,469,1165,506,753,801,408,2103,4878,14230,3616,3633,7249,6981,5,3,24041,1,24
52,410,"WASHINGTON",18730,18730,0,0,2657,1193,1577,1481,1113,2547,1172,1598,1307,946,483,2656,18730,8021,7570,15591,3139,5,3,24043,1,24
52,450,"WORCESTER",16971,16971,0,0,1916,908,1049,1205,687,1702,883,1174,1217,749,1054,4427,16971,5765,5725,11490,5481,5,3,24047,1,24
52,5100,"BALTIMORE CITY",46555,46555,46555,46555,5315,2439,4304,5356,1651,5183,2410,3799,3884,1871,5671,4672,46555,19065,17147,36212,10343,5,3,24510,1,24
52,0,"MARYLAND",380546,380546,46555,46555,38613,18489,22688,25255,15165,36137,17833,23875,22908,14154,33927,111502,380546,120210,114907,235117,145429,5,3,24000,2,24
54,10,"ANDERSON",3959,3959,0,0,742,315,327,293,196,735,303,336,301,146,5,260,3959,1873,1821,3694,265,6,4,47001,1,47
54,30,"BEDFORD",8242,8242,0,0,1528,578,583,704,304,1433,476,618,601,232,5,1180,8242,3697,3360,7057,1185,6,4,47003,1,47
54,70,"BLEDSOE",3259,3259,0,0,640,279,290,248,128,591,267,267,255,85,3,206,3259,1585,1465,3050,209,6,4,47007,1,47
54,90,"BLOUNT",8839,8839,0,0,1580,684,699,727,432,1481,563,782,675,385,26,805,8839,4122,3886,8008,831,6,4,47009,1,47
54,130,"CAMPBELL",2668,2668,0,0,496,221,235,224,112,510,189,220,203,97,58,103,2668,1288,1219,2507,161,6,4,47013,1,47
54,190,"CARTER",4190,4190,0,0,786,407,303,273,190,787,415,372,264,131,0,262,4190,1959,1969,3928,262,6,4,47019,1,47
54,250,"CLAIBORNE",4798,4798,0,0,964,354,360,378,221,864,365,422,343,165,35,327,4798,2277,2159,4436,362,6,4,47025,1,47
54,290,"COCKE",5154,5154,0,0,894,389,411,420,324,830,372,424,357,281,16,436,5154,2438,2264,4702,452,6,4,47029,1,47
54,370,"DAVIDSON",15608,15608,0,0,1673,706,1045,950,557,1572,838,791,695,346,130,6305,15608,4931,4242,9173,6435,6,4,47037,1,47
54,430,"DICKSON",4516,4516,0,0,740,250,330,345,172,721,224,333,285,136,0,980,4516,1837,1699,3536,980,6,4,47043,1,47
54,510,"FRANKLIN",5730,5730,0,0,1158,363,430,513,204,1000,359,457,387,149,1,709,5730,2668,2352,5020,710,6,4,47051,1,47
54,550,"GILES",4546,4546,0,0,840,286,353,427,124,753,257,383,283,107,0,733,4546,2030,1783,3813,733,6,4,47055,1,47
54,570,"GRAINGER",6397,6397,0,0,1115,478,548,438,315,1029,481,542,462,270,182,537,6397,2894,2784,5678,719,6,4,47057,1,47
54,590,"GREENE",9713,9713,0,0,1833,778,808,688,501,1665,715,892,718,448,12,655,9713,4608,4438,9046,667,6,4,47059,1,47
54,730,"HAWKINS",7643,7643,0,0,1385,568,600,558,361,1221,541,615,527,321,16,930,7643,3472,3225,6697,946,6,4,47073,1,47
54,810,"HICKMAN",2583,2583,0,0,537,195,194,327,85,361,153,228,187,65,6,245,2583,1338,994,2332,251,6,4,47081,1,47
54,850,"HUMPHREYS",1511,1511,0,0,282,120,124,128,57,280,96,118,110,51,13,132,1511,711,655,1366,145,6,4,47085,1,47
54,870,"JACKSON",5401,5401,0,0,1067,400,388,458,235,1053,340,387,419,165,8,481,5401,2548,2364,4912,489,6,4,47087,1,47
54,890,"JEFFERSON",7309,7309,0,0,1296,510,626,524,348,1277,473,586,518,294,74,783,7309,3304,3148,6452,857,6,4,47089,1,47
54,930,"KNOX",10171,10171,0,0,1763,686,840,768,500,1653,661,840,731,434,24,1271,10171,4557,4319,8876,1295,6,4,47093,1,47
54,1030,"LINCOLN",6104,6104,0,0,1153,345,501,610,190,1113,332,526,443,169,2,720,6104,2799,2583,5382,722,6,4,47103,1,47
54,1190,"MAURY",10359,10359,0,0,1611,576,717,822,315,1515,553,716,637,260,11,2626,10359,4041,3681,7722,2637,6,4,47119,1,47
54,1250,"MONTGOMERY",8021,8021,0,0,1074,420,501,535,293,1037,369,493,441,223,6,2629,8021,2823,2563,5386,2635,6,4,47125,1,47
54,1330,"OVERTON",5643,5643,0,0,1060,402,434,510,228,1191,358,489,439,171,6,355,5643,2634,2648,5282,361,6,4,47133,1,47
54,1430,"RHEA",2504,2504,0,0,492,160,182,234,97,497,135,215,200,78,0,214,2504,1165,1125,2290,214,6,4,47143,1,47
54,1450,"ROANE",5581,5581,0,0,1051,389,434,425,221,1018,362,414,412,170,15,670,5581,2520,2376,4896,685,6,4,47145,1,47
54,1470,"ROBERTSON",7270,7270,0,0,1216,445,453,588,236,1066,434,508,483,194,39,1608,7270,2938,2685,5623,1647,6,4,47147,1,47
54,1490,"RUTHERFORD",10265,10265,0,0,1545,562,713,758,346,1494,548,642,664,255,37,2701,10265,3924,3603,7527,2738,6,4,47149,1,47
54,1550,"SEVIER",4595,4595,0,0,825,348,418,325,258,858,349,389,327,199,5,294,4595,2174,2122,4296,299,6,4,47155,1,47
54,1590,"SMITH",11649,11649,0,0,2015,712,810,887,440,1889,660,843,796,372,24,2201,11649,4864,4560,9424,2225,6,4,47159,1,47
54,1610,"STEWART",4262,4262,0,0,730,288,303,367,141,661,258,288,317,112,18,779,4262,1829,1636,3465,797,6,4,47161,1,47
54,1630,"SULLIVAN",6847,6847,0,0,1174,482,540,492,377,1112,490,591,517,296,3,773,6847,3065,3006,6071,776,6,4,47163,1,47
54,1650,"SUMNER",13792,13792,0,0,1921,772,1024,921,507,1848,710,994,828,436,97,3734,13792,5145,4816,9961,3831,6,4,47165,1,47
54,1770,"WARREN",5725,5725,0,0,1167,388,427,401,225,1159,417,481,404,172,8,476,5725,2608,2633,5241,484,6,4,47177,1,47
54,1790,"WASHINGTON",7740,7740,0,0,1356,570,645,524,417,1288,535,652,538,329,36,850,7740,3512,3342,6854,886,6,4,47179,1,47
54,1850,"WHITE",4028,4028,0,0,806,322,327,337,182,727,290,338,297,119,0,283,4028,1974,1771,3745,283,6,4,47185,1,47
54,1870,"WILLIAMSON",13153,13153,0,0,2004,701,795,945,414,1652,697,834,783,331,12,3985,13153,4859,4297,9156,3997,6,4,47187,1,47
54,1890,"WILSON",11952,11952,0,0,1975,721,768,885,403,1869,744,838,777,291,384,2297,11952,4752,4519,9271,2681,6,4,47189,1,47
54,0,"TENNESSEE",261727,261727,0,0,44494,17170,19486,19957,10656,41810,16329,19864,17624,8485,1317,44535,261727,111763,104112,215875,45852,6,4,47000,2,47
98,3,"WASHINGTON CITY",8208,8208,8208,0,933,287,469,864,342,966,375,691,721,256,867,1437,8208,2895,3009,5904,2304,5,3,11001.2,1,11
98,5,"GEORGETOWN",4948,4948,4948,0,497,324,371,327,159,518,280,335,249,175,551,1162,4948,1678,1557,3235,1713,5,3,11001.1,1,11
98,7,"RURAL WASHINGTON CO",2315,2315,0,0,176,95,116,142,89,176,87,101,136,88,154,955,2315,618,588,1206,1109,5,3,11001.3,1,11
98,33,"ALEXANDRIA",7227,7227,7227,0,731,391,507,680,216,733,386,461,547,251,836,1488,7227,2525,2378,4903,2324,5,3,51510,1,11
98,35,"RURAL FAIRFAX CO IN DC",1325,1325,0,0,142,61,57,94,60,145,64,65,81,62,141,353,1325,414,417,831,494,5,3,51013,1,11
98,0,"DIST COLUMBIA",24023,24023,20383,0,2479,1158,1520,2107,866,2538,1192,1653,1734,832,2549,5395,24023,8130,7949,16079,7944,5,3,11000,2,11
100,0,"UNITED STATES",7239814,7239881,525457,230437,1035058,468083,547597,571997,364836,981421,448322,561956,544256,338478,186446,1191364,7239814,2987571,2874433,5862004,1377810,0,0,,3,
